,Date,Narration,Ref_no,Value_dt,Withdrawl,Deposit,Closing Balance,clean_narration,doc_topic,topic_desc
0,01/07/22,UPI-JAR  SAVE DAILY-JARMYJARONLINE@YBL-YESB0YBLUPI-218249800677-SUBSCRIPTION DEBIT,0000218249800677,01/07/22,20.0,,34304.26, jar save daily,1,"[list([('jar save daily', 98.03861898739333), ('jar save', 98.03682857485501), ('save daily', 98.03586853418446), ('delight paytm', 3.920523474443698), ('country delight', 3.9147386407433222)])]"
1,02/07/22,UPI-JAR  SAVE DAILY-JARMYJARONLINE@YBL-YESB0YBLUPI-218327074783-SUBSCRIPTION DEBIT,0000218327074783,02/07/22,21.0,,34283.26, jar save daily,1,"[list([('jar save daily', 98.03861898739333), ('jar save', 98.03682857485501), ('save daily', 98.03586853418446), ('delight paytm', 3.920523474443698), ('country delight', 3.9147386407433222)])]"
2,03/07/22,UPI-JAR  SAVE DAILY-JARMYJARONLINE@YBL-YESB0YBLUPI-218430894428-SUBSCRIPTION DEBIT,0000218430894428,03/07/22,20.0,,34263.26, jar save daily,1,"[list([('jar save daily', 98.03861898739333), ('jar save', 98.03682857485501), ('save daily', 98.03586853418446), ('delight paytm', 3.920523474443698), ('country delight', 3.9147386407433222)])]"
3,03/07/22,UPI-NARESH PUROHIT-NP1784534@OKHDFCBANK-HDFC0003522-218435006946-UPI,0000218435006946,03/07/22,20.0,,34243.26, naresh purohit np,4,"[list([('naresh purohit', 11.170927092504018), ('purohit np', 11.167440746173527), ('naresh purohit np', 11.166542020373829), ('gagan pan', 0.13119500953407723), ('pan shop', 0.1307016139459496)])]"
4,04/07/22,UPI-KRISHNA VEGETABLES A-PAYTMQR281005050101OGH9MJCCHZHN@PAYTM-PYTM0123456-218563429825-UPI,0000218563429825,04/07/22,25.0,,34218.26, krishna vegetables a,2,"[list([('gupta juice', 19.243605119465393), ('gupta juice center', 19.24314059509313), ('juice center', 19.241968449100682), ('krishna vegetables', 4.4101114348673125), ('cred club', 3.506991506858471)])]"
5,05/07/22,UPI-JAR  SAVE DAILY-JARMYJARONLINE@YBL-YESB0YBLUPI-218650928183-SUBSCRIPTION DEBIT,0000218650928183,05/07/22,20.0,,34198.26, jar save daily,1,"[list([('jar save daily', 98.03861898739333), ('jar save', 98.03682857485501), ('save daily', 98.03586853418446), ('delight paytm', 3.920523474443698), ('country delight', 3.9147386407433222)])]"
6,05/07/22,UPI-JAR  SAVE DAILY-JARMYJARONLINE@YBL-YESB0YBLUPI-218622207927-SUBSCRIPTION DEBIT,0000218622207927,05/07/22,20.0,,34178.26, jar save daily,1,"[list([('jar save daily', 98.03861898739333), ('jar save', 98.03682857485501), ('save daily', 98.03586853418446), ('delight paytm', 3.920523474443698), ('country delight', 3.9147386407433222)])]"
7,06/07/22,UPI-JAR  SAVE DAILY-JARMYJARONLINE@YBL-YESB0YBLUPI-218727475241-SUBSCRIPTION DEBIT,0000218727475241,06/07/22,20.0,,34158.26, jar save daily,1,"[list([('jar save daily', 98.03861898739333), ('jar save', 98.03682857485501), ('save daily', 98.03586853418446), ('delight paytm', 3.920523474443698), ('country delight', 3.9147386407433222)])]"
8,07/07/22,UPI-JAR  SAVE DAILY-JARMYJARONLINE@YBL-YESB0YBLUPI-218870601644-SUBSCRIPTION DEBIT,0000218870601644,07/07/22,20.0,,34138.26, jar save daily,1,"[list([('jar save daily', 98.03861898739333), ('jar save', 98.03682857485501), ('save daily', 98.03586853418446), ('delight paytm', 3.920523474443698), ('country delight', 3.9147386407433222)])]"
9,08/07/22,UPI-JAR  SAVE DAILY-JARMYJARONLINE@YBL-YESB0YBLUPI-218916681686-SUBSCRIPTION DEBIT,0000218916681686,08/07/22,20.0,,34118.26, jar save daily,1,"[list([('jar save daily', 98.03861898739333), ('jar save', 98.03682857485501), ('save daily', 98.03586853418446), ('delight paytm', 3.920523474443698), ('country delight', 3.9147386407433222)])]"
10,08/07/22,UPI-MYNTRA-MYNTRA.PAYU@HDFCBANK-HDFC0000499-218936604811-UPI,0000218936604811,08/07/22,2598.0,,31520.26, myntra myntra payu,0,"[list([('aayushi super', 10.865290481053918), ('super shoppy', 10.865173862517079), ('aayushi super shoppy', 10.864427223847468), ('pos xxxxxx', 2.4550385779352015), ('ikea india', 1.609971068597172)])]"
11,09/07/22,UPI-JAR  SAVE DAILY-JARMYJARONLINE@YBL-YESB0YBLUPI-219063973915-SUBSCRIPTION DEBIT,0000219063973915,09/07/22,20.0,,31500.26, jar save daily,1,"[list([('jar save daily', 98.03861898739333), ('jar save', 98.03682857485501), ('save daily', 98.03586853418446), ('delight paytm', 3.920523474443698), ('country delight', 3.9147386407433222)])]"
12,09/07/22,UPI-OLA MONEY-OLAMONEY1.RZP@AXISBANK-UTIB0001507-219054815375-UPI,0000219054815375,09/07/22,137.0,,31363.26, ola money olamoney,9,"[list([('si tad', 2.035923755867459), ('autopay si tad', 2.0352256901407024), ('autopay si', 2.0348731549436505), ('dc autopay si', 2.032376855832404), ('dc autopay', 2.0312507869052774)])]"
13,09/07/22,UPI-JIOFIBER-JIOFIBER@YESBANK-YESB0000248-219059314098-JIO20TB00001T7PN30,0000219059314098,09/07/22,824.82,,30538.44, jiofiber jiofiber,8,"[list([('sumit mohan', 4.505268486902978), ('mohan gupta', 4.504494554311667), ('sumit mohan gupta', 4.502622451115006), ('jiofiber jiofiber', 2.613046376779851), ('olamoney razorpay', 1.7976716994787716)])]"
14,10/07/22,UPI-JAR  SAVE DAILY-JARMYJARONLINE@YBL-YESB0YBLUPI-219150821362-SUBSCRIPTION DEBIT,0000219150821362,10/07/22,20.0,,30518.44, jar save daily,1,"[list([('jar save daily', 98.03861898739333), ('jar save', 98.03682857485501), ('save daily', 98.03586853418446), ('delight paytm', 3.920523474443698), ('country delight', 3.9147386407433222)])]"
15,11/07/22,UPI-JAR  SAVE DAILY-JARMYJARONLINE@YBL-YESB0YBLUPI-219275244997-SUBSCRIPTION DEBIT,0000219275244997,11/07/22,20.0,,30498.44, jar save daily,1,"[list([('jar save daily', 98.03861898739333), ('jar save', 98.03682857485501), ('save daily', 98.03586853418446), ('delight paytm', 3.920523474443698), ('country delight', 3.9147386407433222)])]"
16,11/07/22,50400264425075- RD INSTALLMENT-JUL 2022,000000000000000,11/07/22,1400.0,,29098.44, rd installment jul,7,"[list([('raj vegetables gpay', 4.360523938382696), ('vegetables gpay', 4.3601697153875785), ('raj vegetables', 4.359825827176104), ('stores paytmqr', 3.567746696089187), ('hair glow', 2.506362310298007)])]"
17,12/07/22,UPI-JAR  SAVE DAILY-JARMYJARONLINE@YBL-YESB0YBLUPI-219390970394-SUBSCRIPTION DEBIT,0000219390970394,12/07/22,20.0,,29078.44, jar save daily,1,"[list([('jar save daily', 98.03861898739333), ('jar save', 98.03682857485501), ('save daily', 98.03586853418446), ('delight paytm', 3.920523474443698), ('country delight', 3.9147386407433222)])]"
18,13/07/22,UPI-JAR  SAVE DAILY-JARMYJARONLINE@YBL-YESB0YBLUPI-219410334829-SUBSCRIPTION DEBIT,0000219410334829,13/07/22,20.0,,29058.44, jar save daily,1,"[list([('jar save daily', 98.03861898739333), ('jar save', 98.03682857485501), ('save daily', 98.03586853418446), ('delight paytm', 3.920523474443698), ('country delight', 3.9147386407433222)])]"
19,13/07/22,UPI-NARESH PUROHIT-NP1784534@OKHDFCBANK-HDFC0003522-219443016371-BLDG 94 PANEER,0000219443016371,13/07/22,218.0,,28840.44, naresh purohit np,4,"[list([('naresh purohit', 11.170927092504018), ('purohit np', 11.167440746173527), ('naresh purohit np', 11.166542020373829), ('gagan pan', 0.13119500953407723), ('pan shop', 0.1307016139459496)])]"
20,13/07/22,UPI-RS MANI CAFE TILAK N-PAYTMQR281005050101MXMW793VKX3W@PAYTM-PYTM0123456-219444812186-UPI,0000219444812186,13/07/22,30.0,,28810.44, rs mani cafe,0,"[list([('aayushi super', 10.865290481053918), ('super shoppy', 10.865173862517079), ('aayushi super shoppy', 10.864427223847468), ('pos xxxxxx', 2.4550385779352015), ('ikea india', 1.609971068597172)])]"
21,13/07/22,50400269095673- RD INSTALLMENT-MAY 2022,000000000000000,13/07/22,10000.0,,18810.44, rd installment may,5,"[list([('rd installment', 5.604710649033009), ('shantidhan stores', 2.7402329765419635), ('stores gpay', 2.7390542080882083), ('shantidhan stores gpay', 2.7366626902016304), ('installment dec', 2.0266108955371855)])]"
22,13/07/22,50400269095673- RD INSTALLMENT-JUN 2022,000000000000000,13/07/22,10000.0,,8810.44, rd installment jun,5,"[list([('rd installment', 5.604710649033009), ('shantidhan stores', 2.7402329765419635), ('stores gpay', 2.7390542080882083), ('shantidhan stores gpay', 2.7366626902016304), ('installment dec', 2.0266108955371855)])]"
23,14/07/22,UPI-JAR  SAVE DAILY-JARMYJARONLINE@YBL-YESB0YBLUPI-219501040262-SUBSCRIPTION DEBIT,0000219501040262,14/07/22,20.0,,8790.44, jar save daily,1,"[list([('jar save daily', 98.03861898739333), ('jar save', 98.03682857485501), ('save daily', 98.03586853418446), ('delight paytm', 3.920523474443698), ('country delight', 3.9147386407433222)])]"
24,14/07/22,UPI-BALAJI HOT CHIPS-BALAJIHOTCHIPS.99779168@HDFCBANK-HDFC0000001-219558539333-UPI,0000219558539333,14/07/22,30.0,,8760.44, balaji hot chips,0,"[list([('aayushi super', 10.865290481053918), ('super shoppy', 10.865173862517079), ('aayushi super shoppy', 10.864427223847468), ('pos xxxxxx', 2.4550385779352015), ('ikea india', 1.609971068597172)])]"
25,14/07/22,UPI-GAGAN PAN SHOP-PAYTMQR28100505010114WJI6OVAW2B@PAYTM-PYTM0123456-219558664615-UPI,0000219558664615,14/07/22,18.0,,8742.44, gagan pan shop,8,"[list([('sumit mohan', 4.505268486902978), ('mohan gupta', 4.504494554311667), ('sumit mohan gupta', 4.502622451115006), ('jiofiber jiofiber', 2.613046376779851), ('olamoney razorpay', 1.7976716994787716)])]"
26,15/07/22,UPI-JAR  SAVE DAILY-JARMYJARONLINE@YBL-YESB0YBLUPI-219607444713-SUBSCRIPTION DEBIT,0000219607444713,15/07/22,20.0,,8722.44, jar save daily,1,"[list([('jar save daily', 98.03861898739333), ('jar save', 98.03682857485501), ('save daily', 98.03586853418446), ('delight paytm', 3.920523474443698), ('country delight', 3.9147386407433222)])]"
27,15/07/22,DC EMI LOAN# 82486255 15-07-2022,000000000000000,15/07/22,15077.11,,-6354.67,dc emi loan ,0,"[list([('aayushi super', 10.865290481053918), ('super shoppy', 10.865173862517079), ('aayushi super shoppy', 10.864427223847468), ('pos xxxxxx', 2.4550385779352015), ('ikea india', 1.609971068597172)])]"
29,16/07/22,UPI-JAR  SAVE DAILY-JARMYJARONLINE@YBL-YESB0YBLUPI-219736248953-SUBSCRIPTION DEBIT,0000219736248953,16/07/22,20.0,,8702.44, jar save daily,1,"[list([('jar save daily', 98.03861898739333), ('jar save', 98.03682857485501), ('save daily', 98.03586853418446), ('delight paytm', 3.920523474443698), ('country delight', 3.9147386407433222)])]"
30,17/07/22,UPI-JAR  SAVE DAILY-JARMYJARONLINE@YBL-YESB0YBLUPI-219802602161-SUBSCRIPTION DEBIT,0000219802602161,17/07/22,20.0,,8682.44, jar save daily,1,"[list([('jar save daily', 98.03861898739333), ('jar save', 98.03682857485501), ('save daily', 98.03586853418446), ('delight paytm', 3.920523474443698), ('country delight', 3.9147386407433222)])]"
31,18/07/22,UPI-JAR  SAVE DAILY-JARMYJARONLINE@YBL-YESB0YBLUPI-219964630957-SUBSCRIPTION DEBIT,0000219964630957,18/07/22,20.0,,8662.44, jar save daily,1,"[list([('jar save daily', 98.03861898739333), ('jar save', 98.03682857485501), ('save daily', 98.03586853418446), ('delight paytm', 3.920523474443698), ('country delight', 3.9147386407433222)])]"
32,19/07/22,UPI-JAR  SAVE DAILY-JARMYJARONLINE@YBL-YESB0YBLUPI-220031045511-SUBSCRIPTION DEBIT,0000220031045511,19/07/22,20.0,,8642.44, jar save daily,1,"[list([('jar save daily', 98.03861898739333), ('jar save', 98.03682857485501), ('save daily', 98.03586853418446), ('delight paytm', 3.920523474443698), ('country delight', 3.9147386407433222)])]"
33,19/07/22,UPI-NARESH PUROHIT-NP1784534@OKHDFCBANK-HDFC0003522-220047768275-UPI,0000220047768275,19/07/22,218.0,,8424.44, naresh purohit np,4,"[list([('naresh purohit', 11.170927092504018), ('purohit np', 11.167440746173527), ('naresh purohit np', 11.166542020373829), ('gagan pan', 0.13119500953407723), ('pan shop', 0.1307016139459496)])]"
34,19/07/22,UPI-GAGAN PAN SHOP-PAYTMQR28100505010114WJI6OVAW2B@PAYTM-PYTM0123456-220058192635-UPI,0000220058192635,19/07/22,18.0,,8406.44, gagan pan shop,8,"[list([('sumit mohan', 4.505268486902978), ('mohan gupta', 4.504494554311667), ('sumit mohan gupta', 4.502622451115006), ('jiofiber jiofiber', 2.613046376779851), ('olamoney razorpay', 1.7976716994787716)])]"
35,20/07/22,UPI-JAR  SAVE DAILY-JARMYJARONLINE@YBL-YESB0YBLUPI-220119929886-SUBSCRIPTION DEBIT,0000220119929886,20/07/22,20.0,,8386.44, jar save daily,1,"[list([('jar save daily', 98.03861898739333), ('jar save', 98.03682857485501), ('save daily', 98.03586853418446), ('delight paytm', 3.920523474443698), ('country delight', 3.9147386407433222)])]"
36,21/07/22,UPI-JAR  SAVE DAILY-JARMYJARONLINE@YBL-YESB0YBLUPI-220228789165-SUBSCRIPTION DEBIT,0000220228789165,21/07/22,20.0,,8366.44, jar save daily,1,"[list([('jar save daily', 98.03861898739333), ('jar save', 98.03682857485501), ('save daily', 98.03586853418446), ('delight paytm', 3.920523474443698), ('country delight', 3.9147386407433222)])]"
37,22/07/22,UPI-JAR  SAVE DAILY-JARMYJARONLINE@YBL-YESB0YBLUPI-220355198286-SUBSCRIPTION DEBIT,0000220355198286,22/07/22,20.0,,8346.44, jar save daily,1,"[list([('jar save daily', 98.03861898739333), ('jar save', 98.03682857485501), ('save daily', 98.03586853418446), ('delight paytm', 3.920523474443698), ('country delight', 3.9147386407433222)])]"
38,23/07/22,UPI-REVV-REVV.RZP@AXISBANK-UTIB0001506-220424292234-REVV,0000220424292234,23/07/22,8190.0,,156.44, revv revv rzp,0,"[list([('aayushi super', 10.865290481053918), ('super shoppy', 10.865173862517079), ('aayushi super shoppy', 10.864427223847468), ('pos xxxxxx', 2.4550385779352015), ('ikea india', 1.609971068597172)])]"
39,23/07/22,UPI-JAR  SAVE DAILY-JARMYJARONLINE@YBL-YESB0YBLUPI-220460781512-SUBSCRIPTION DEBIT,0000220460781512,23/07/22,20.0,,136.44, jar save daily,1,"[list([('jar save daily', 98.03861898739333), ('jar save', 98.03682857485501), ('save daily', 98.03586853418446), ('delight paytm', 3.920523474443698), ('country delight', 3.9147386407433222)])]"
40,24/07/22,UPI-JAR  SAVE DAILY-JARMYJARONLINE@YBL-YESB0YBLUPI-220583098469-SUBSCRIPTION DEBIT,0000220583098469,24/07/22,30.0,,106.44, jar save daily,1,"[list([('jar save daily', 98.03861898739333), ('jar save', 98.03682857485501), ('save daily', 98.03586853418446), ('delight paytm', 3.920523474443698), ('country delight', 3.9147386407433222)])]"
41,24/07/22,UPI-JAY MALHAR AUTOMOBIL-GPAY-11195675667@OKBIZAXIS-UTIB0000000-220549098814-UPI,0000220549098814,24/07/22,100.0,,6.44, jay malhar automobil,0,"[list([('aayushi super', 10.865290481053918), ('super shoppy', 10.865173862517079), ('aayushi super shoppy', 10.864427223847468), ('pos xxxxxx', 2.4550385779352015), ('ikea india', 1.609971068597172)])]"
43,26/07/22,UPI-JAR  SAVE DAILY-JARMYJARONLINE@YBL-YESB0YBLUPI-220763427779-SUBSCRIPTION DEBIT,0000220763427779,26/07/22,20.0,,3311.44, jar save daily,1,"[list([('jar save daily', 98.03861898739333), ('jar save', 98.03682857485501), ('save daily', 98.03586853418446), ('delight paytm', 3.920523474443698), ('country delight', 3.9147386407433222)])]"
44,27/07/22,UPI-JAR  SAVE DAILY-JARMYJARONLINE@YBL-YESB0YBLUPI-220820865467-SUBSCRIPTION DEBIT,0000220820865467,27/07/22,40.0,,3271.44, jar save daily,1,"[list([('jar save daily', 98.03861898739333), ('jar save', 98.03682857485501), ('save daily', 98.03586853418446), ('delight paytm', 3.920523474443698), ('country delight', 3.9147386407433222)])]"
45,28/07/22,UPI-JAR  SAVE DAILY-JARMYJARONLINE@YBL-YESB0YBLUPI-220971391223-SUBSCRIPTION DEBIT,0000220971391223,28/07/22,20.0,,3251.44, jar save daily,1,"[list([('jar save daily', 98.03861898739333), ('jar save', 98.03682857485501), ('save daily', 98.03586853418446), ('delight paytm', 3.920523474443698), ('country delight', 3.9147386407433222)])]"
47,29/07/22,UPI-JAR  SAVE DAILY-JARMYJARONLINE@YBL-YESB0YBLUPI-221065494184-SUBSCRIPTION DEBIT,0000221065494184,29/07/22,20.0,,3232.44, jar save daily,1,"[list([('jar save daily', 98.03861898739333), ('jar save', 98.03682857485501), ('save daily', 98.03586853418446), ('delight paytm', 3.920523474443698), ('country delight', 3.9147386407433222)])]"
49,30/07/22,UPI-JAR  SAVE DAILY-JARMYJARONLINE@YBL-YESB0YBLUPI-221100309318-SUBSCRIPTION DEBIT,0000221100309318,30/07/22,20.0,,93670.44, jar save daily,1,"[list([('jar save daily', 98.03861898739333), ('jar save', 98.03682857485501), ('save daily', 98.03586853418446), ('delight paytm', 3.920523474443698), ('country delight', 3.9147386407433222)])]"
50,30/07/22,UPI-CREDCLUB1-CRED.CLUB@AXISB-UTIB0000114-221109442460-PAYMENT ON CRED,0000221109442460,30/07/22,39330.0,,54340.44, credclub cred club,2,"[list([('gupta juice', 19.243605119465393), ('gupta juice center', 19.24314059509313), ('juice center', 19.241968449100682), ('krishna vegetables', 4.4101114348673125), ('cred club', 3.506991506858471)])]"
51,30/07/22,UPI-CREDCLUB1-CRED.CLUB@AXISB-UTIB0000114-221109903560-PAYMENT ON CRED,0000221109903560,30/07/22,1178.82,,53161.62, credclub cred club,2,"[list([('gupta juice', 19.243605119465393), ('gupta juice center', 19.24314059509313), ('juice center', 19.241968449100682), ('krishna vegetables', 4.4101114348673125), ('cred club', 3.506991506858471)])]"
52,30/07/22,UPI-SUMIT MOHAN GUPTA-SUMITMG@OKICICI-BARB0PANKIX-221175938624-EDUCATION LOAN,0000221175938624,30/07/22,25000.0,,28161.62, sumit mohan gupta,8,"[list([('sumit mohan', 4.505268486902978), ('mohan gupta', 4.504494554311667), ('sumit mohan gupta', 4.502622451115006), ('jiofiber jiofiber', 2.613046376779851), ('olamoney razorpay', 1.7976716994787716)])]"
53,31/07/22,UPI-JAR  SAVE DAILY-JARMYJARONLINE@YBL-YESB0YBLUPI-221283614925-SUBSCRIPTION DEBIT,0000221283614925,31/07/22,20.0,,28141.62, jar save daily,1,"[list([('jar save daily', 98.03861898739333), ('jar save', 98.03682857485501), ('save daily', 98.03586853418446), ('delight paytm', 3.920523474443698), ('country delight', 3.9147386407433222)])]"
54,31/07/22,NWD-512967XXXXXX4210-ATM07401-MUMBAI,0000221211675579,31/07/22,10000.0,,18141.62,nwd xxxxxx atm mumbai,0,"[list([('aayushi super', 10.865290481053918), ('super shoppy', 10.865173862517079), ('aayushi super shoppy', 10.864427223847468), ('pos xxxxxx', 2.4550385779352015), ('ikea india', 1.609971068597172)])]"
55,01/08/22,UPI-JAR  SAVE DAILY-JARMYJARONLINE@YBL-YESB0YBLUPI-221332084665-SUBSCRIPTION DEBIT,0000221332084665,01/08/22,40.0,,18101.62, jar save daily,1,"[list([('jar save daily', 98.03861898739333), ('jar save', 98.03682857485501), ('save daily', 98.03586853418446), ('delight paytm', 3.920523474443698), ('country delight', 3.9147386407433222)])]"
56,02/08/22,UPI-JAR  SAVE DAILY-JARMYJARONLINE@YBL-YESB0YBLUPI-221477133107-SUBSCRIPTION DEBIT,0000221477133107,02/08/22,36.0,,18065.62, jar save daily,1,"[list([('jar save daily', 98.03861898739333), ('jar save', 98.03682857485501), ('save daily', 98.03586853418446), ('delight paytm', 3.920523474443698), ('country delight', 3.9147386407433222)])]"
58,03/08/22,UPI-JAR  SAVE DAILY-JARMYJARONLINE@YBL-YESB0YBLUPI-221542142099-SUBSCRIPTION DEBIT,0000221542142099,03/08/22,20.0,,19449.01, jar save daily,1,"[list([('jar save daily', 98.03861898739333), ('jar save', 98.03682857485501), ('save daily', 98.03586853418446), ('delight paytm', 3.920523474443698), ('country delight', 3.9147386407433222)])]"
59,04/08/22,UPI-JAR  SAVE DAILY-JARMYJARONLINE@YBL-YESB0YBLUPI-221652850888-SUBSCRIPTION DEBIT,0000221652850888,04/08/22,20.0,,19429.01, jar save daily,1,"[list([('jar save daily', 98.03861898739333), ('jar save', 98.03682857485501), ('save daily', 98.03586853418446), ('delight paytm', 3.920523474443698), ('country delight', 3.9147386407433222)])]"
60,05/08/22,UPI-JAR  SAVE DAILY-JARMYJARONLINE@YBL-YESB0YBLUPI-221718228460-SUBSCRIPTION DEBIT,0000221718228460,05/08/22,20.0,,19409.01, jar save daily,1,"[list([('jar save daily', 98.03861898739333), ('jar save', 98.03682857485501), ('save daily', 98.03586853418446), ('delight paytm', 3.920523474443698), ('country delight', 3.9147386407433222)])]"
61,05/08/22,DC 1019060021591624 AUTOPAY SI-TAD,0000000444965200,05/08/22,1963.41,,17445.6,dc autopay si tad,9,"[list([('si tad', 2.035923755867459), ('autopay si tad', 2.0352256901407024), ('autopay si', 2.0348731549436505), ('dc autopay si', 2.032376855832404), ('dc autopay', 2.0312507869052774)])]"
62,05/08/22,UPI-KANPUR PANKI RETAILE-PAYTMQR281005050101BKPB4G4WQH08@PAYTM-PYTM0123456-221700971054-UPI,0000221700971054,05/08/22,89.0,,17356.6, kanpur panki retaile,0,"[list([('aayushi super', 10.865290481053918), ('super shoppy', 10.865173862517079), ('aayushi super shoppy', 10.864427223847468), ('pos xxxxxx', 2.4550385779352015), ('ikea india', 1.609971068597172)])]"
63,05/08/22,UPI-RAHULSWEETS AND NAMK-GPAY-11204277469@OKBIZAXIS-UTIB0000000-221701174990-UPI,0000221701174990,05/08/22,457.0,,16899.6, rahulsweets and namk,0,"[list([('aayushi super', 10.865290481053918), ('super shoppy', 10.865173862517079), ('aayushi super shoppy', 10.864427223847468), ('pos xxxxxx', 2.4550385779352015), ('ikea india', 1.609971068597172)])]"
64,06/08/22,UPI-JAR  SAVE DAILY-JARMYJARONLINE@YBL-YESB0YBLUPI-221856700386-SUBSCRIPTION DEBIT,0000221856700386,06/08/22,22.0,,16877.6, jar save daily,1,"[list([('jar save daily', 98.03861898739333), ('jar save', 98.03682857485501), ('save daily', 98.03586853418446), ('delight paytm', 3.920523474443698), ('country delight', 3.9147386407433222)])]"
65,06/08/22,UPI-PRADEEP  P-9198141821@YBL-SBIN0011330-221850215360-CASH,0000221850215360,06/08/22,5500.0,,11377.6, pradeep p ,0,"[list([('aayushi super', 10.865290481053918), ('super shoppy', 10.865173862517079), ('aayushi super shoppy', 10.864427223847468), ('pos xxxxxx', 2.4550385779352015), ('ikea india', 1.609971068597172)])]"
66,07/08/22,UPI-JAR  SAVE DAILY-JARMYJARONLINE@YBL-YESB0YBLUPI-221902718775-SUBSCRIPTION DEBIT,0000221902718775,07/08/22,24.0,,11353.6, jar save daily,1,"[list([('jar save daily', 98.03861898739333), ('jar save', 98.03682857485501), ('save daily', 98.03586853418446), ('delight paytm', 3.920523474443698), ('country delight', 3.9147386407433222)])]"
67,07/08/22,UPI-CCAVENUES-CCAVENUES@ICICI-ICIC0DC0099-221947997594-UPI,0000221947997594,07/08/22,2745.5,,8608.1, ccavenues ccavenues,3,"[list([('hungerbox paytm', 13.174251604078895), ('aeml awsp', 3.595276358492651), ('ccavenues ccavenues', 2.5585233143451727), ('premji paytmqr', 1.5287022749836985), ('patel premji paytmqr', 1.5276871161621721)])]"
68,07/08/22,UPI-R M HERITAGEA HOTELS-PAYTM-67861330@PAYTM-PYTM0123456-221958223974-UPI,0000221958223974,07/08/22,1985.0,,6623.1, r m heritagea,0,"[list([('aayushi super', 10.865290481053918), ('super shoppy', 10.865173862517079), ('aayushi super shoppy', 10.864427223847468), ('pos xxxxxx', 2.4550385779352015), ('ikea india', 1.609971068597172)])]"
69,07/08/22,UPI-TGC ENTERPRISES-Q770026994@YBL-YESB0YBLUPI-221958563436-UPI,0000221958563436,07/08/22,110.0,,6513.1, tgc enterprises q,0,"[list([('aayushi super', 10.865290481053918), ('super shoppy', 10.865173862517079), ('aayushi super shoppy', 10.864427223847468), ('pos xxxxxx', 2.4550385779352015), ('ikea india', 1.609971068597172)])]"
70,08/08/22,UPI-JAR  SAVE DAILY-JARMYJARONLINE@YBL-YESB0YBLUPI-222021158541-SUBSCRIPTION DEBIT,0000222021158541,08/08/22,40.0,,6473.1, jar save daily,1,"[list([('jar save daily', 98.03861898739333), ('jar save', 98.03682857485501), ('save daily', 98.03586853418446), ('delight paytm', 3.920523474443698), ('country delight', 3.9147386407433222)])]"
71,09/08/22,UPI-JAR  SAVE DAILY-JARMYJARONLINE@YBL-YESB0YBLUPI-222163315785-SUBSCRIPTION DEBIT,0000222163315785,09/08/22,39.0,,6434.1, jar save daily,1,"[list([('jar save daily', 98.03861898739333), ('jar save', 98.03682857485501), ('save daily', 98.03586853418446), ('delight paytm', 3.920523474443698), ('country delight', 3.9147386407433222)])]"
73,10/08/22,UPI-JAR  SAVE DAILY-JARMYJARONLINE@YBL-YESB0YBLUPI-222214014343-SUBSCRIPTION DEBIT,0000222214014343,10/08/22,24.0,,9155.6, jar save daily,1,"[list([('jar save daily', 98.03861898739333), ('jar save', 98.03682857485501), ('save daily', 98.03586853418446), ('delight paytm', 3.920523474443698), ('country delight', 3.9147386407433222)])]"
74,11/08/22,UPI-JAR  SAVE DAILY-JARMYJARONLINE@YBL-YESB0YBLUPI-222311903753-SUBSCRIPTION DEBIT,0000222311903753,11/08/22,20.0,,9135.6, jar save daily,1,"[list([('jar save daily', 98.03861898739333), ('jar save', 98.03682857485501), ('save daily', 98.03586853418446), ('delight paytm', 3.920523474443698), ('country delight', 3.9147386407433222)])]"
75,12/08/22,50400264425075- RD INSTALLMENT-AUG 2022,000000000000000,11/08/22,1400.0,,7735.6, rd installment aug,8,"[list([('sumit mohan', 4.505268486902978), ('mohan gupta', 4.504494554311667), ('sumit mohan gupta', 4.502622451115006), ('jiofiber jiofiber', 2.613046376779851), ('olamoney razorpay', 1.7976716994787716)])]"
76,12/08/22,UPI-JAR  SAVE DAILY-JARMYJARONLINE@YBL-YESB0YBLUPI-222413711476-SUBSCRIPTION DEBIT,0000222413711476,12/08/22,20.0,,7715.6, jar save daily,1,"[list([('jar save daily', 98.03861898739333), ('jar save', 98.03682857485501), ('save daily', 98.03586853418446), ('delight paytm', 3.920523474443698), ('country delight', 3.9147386407433222)])]"
77,12/08/22,UPI-ZIPCASHCARDSERVICESP-OLAMONEY1.RAZORPAY@ICICI-ICIC0DC0099-222455740169-UPI,0000222455740169,12/08/22,463.0,,7252.6, zipcashcardservicesp olamoney razorpay,8,"[list([('sumit mohan', 4.505268486902978), ('mohan gupta', 4.504494554311667), ('sumit mohan gupta', 4.502622451115006), ('jiofiber jiofiber', 2.613046376779851), ('olamoney razorpay', 1.7976716994787716)])]"
78,13/08/22,UPI-JAR  SAVE DAILY-JARMYJARONLINE@YBL-YESB0YBLUPI-222559489074-SUBSCRIPTION DEBIT,0000222559489074,13/08/22,29.0,,7223.6, jar save daily,1,"[list([('jar save daily', 98.03861898739333), ('jar save', 98.03682857485501), ('save daily', 98.03586853418446), ('delight paytm', 3.920523474443698), ('country delight', 3.9147386407433222)])]"
79,14/08/22,UPI-JAR  SAVE DAILY-JARMYJARONLINE@YBL-YESB0YBLUPI-222671842379-SUBSCRIPTION DEBIT,0000222671842379,14/08/22,27.0,,7196.6, jar save daily,1,"[list([('jar save daily', 98.03861898739333), ('jar save', 98.03682857485501), ('save daily', 98.03586853418446), ('delight paytm', 3.920523474443698), ('country delight', 3.9147386407433222)])]"
80,15/08/22,UPI-JAR  SAVE DAILY-JARMYJARONLINE@YBL-YESB0YBLUPI-222774880335-SUBSCRIPTION DEBIT,0000222774880335,15/08/22,20.0,,7176.6, jar save daily,1,"[list([('jar save daily', 98.03861898739333), ('jar save', 98.03682857485501), ('save daily', 98.03586853418446), ('delight paytm', 3.920523474443698), ('country delight', 3.9147386407433222)])]"
81,15/08/22,UPI-CCAVENUES-CCAVENUES@ICICI-ICIC0DC0099-222715254104-UPI,0000222715254104,15/08/22,2745.5,,4431.1, ccavenues ccavenues,3,"[list([('hungerbox paytm', 13.174251604078895), ('aeml awsp', 3.595276358492651), ('ccavenues ccavenues', 2.5585233143451727), ('premji paytmqr', 1.5287022749836985), ('patel premji paytmqr', 1.5276871161621721)])]"
82,16/08/22,UPI-JAR  SAVE DAILY-JARMYJARONLINE@YBL-YESB0YBLUPI-222875800235-SUBSCRIPTION DEBIT,0000222875800235,16/08/22,22.0,,4409.1, jar save daily,1,"[list([('jar save daily', 98.03861898739333), ('jar save', 98.03682857485501), ('save daily', 98.03586853418446), ('delight paytm', 3.920523474443698), ('country delight', 3.9147386407433222)])]"
83,17/08/22,UPI-JAR  SAVE DAILY-JARMYJARONLINE@YBL-YESB0YBLUPI-222981000481-SUBSCRIPTION DEBIT,0000222981000481,17/08/22,20.0,,4389.1, jar save daily,1,"[list([('jar save daily', 98.03861898739333), ('jar save', 98.03682857485501), ('save daily', 98.03586853418446), ('delight paytm', 3.920523474443698), ('country delight', 3.9147386407433222)])]"
84,18/08/22,UPI-JAR  SAVE DAILY-JARMYJARONLINE@YBL-YESB0YBLUPI-223069754826-SUBSCRIPTION DEBIT,0000223069754826,18/08/22,20.0,,4369.1, jar save daily,1,"[list([('jar save daily', 98.03861898739333), ('jar save', 98.03682857485501), ('save daily', 98.03586853418446), ('delight paytm', 3.920523474443698), ('country delight', 3.9147386407433222)])]"
85,19/08/22,UPI-JAR  SAVE DAILY-JARMYJARONLINE@YBL-YESB0YBLUPI-223179449881-SUBSCRIPTION DEBIT,0000223179449881,19/08/22,26.0,,4343.1, jar save daily,1,"[list([('jar save daily', 98.03861898739333), ('jar save', 98.03682857485501), ('save daily', 98.03586853418446), ('delight paytm', 3.920523474443698), ('country delight', 3.9147386407433222)])]"
86,19/08/22,UPI-NARESH PUROHIT-NP1784534@OKHDFCBANK-HDFC0003522-223196651819-UPI,0000223196651819,19/08/22,40.0,,4303.1, naresh purohit np,4,"[list([('naresh purohit', 11.170927092504018), ('purohit np', 11.167440746173527), ('naresh purohit np', 11.166542020373829), ('gagan pan', 0.13119500953407723), ('pan shop', 0.1307016139459496)])]"
87,20/08/22,UPI-JAR  SAVE DAILY-JARMYJARONLINE@YBL-YESB0YBLUPI-223284092761-SUBSCRIPTION DEBIT,0000223284092761,20/08/22,20.0,,4283.1, jar save daily,1,"[list([('jar save daily', 98.03861898739333), ('jar save', 98.03682857485501), ('save daily', 98.03586853418446), ('delight paytm', 3.920523474443698), ('country delight', 3.9147386407433222)])]"
88,21/08/22,UPI-JAR  SAVE DAILY-JARMYJARONLINE@YBL-YESB0YBLUPI-223392053613-SUBSCRIPTION DEBIT,0000223392053613,21/08/22,30.0,,4253.1, jar save daily,1,"[list([('jar save daily', 98.03861898739333), ('jar save', 98.03682857485501), ('save daily', 98.03586853418446), ('delight paytm', 3.920523474443698), ('country delight', 3.9147386407433222)])]"
89,22/08/22,UPI-JAR  SAVE DAILY-JARMYJARONLINE@YBL-YESB0YBLUPI-223447370728-SUBSCRIPTION DEBIT,0000223447370728,22/08/22,20.0,,4233.1, jar save daily,1,"[list([('jar save daily', 98.03861898739333), ('jar save', 98.03682857485501), ('save daily', 98.03586853418446), ('delight paytm', 3.920523474443698), ('country delight', 3.9147386407433222)])]"
90,23/08/22,UPI-JAR  SAVE DAILY-JARMYJARONLINE@YBL-YESB0YBLUPI-223573736977-SUBSCRIPTION DEBIT,0000223573736977,23/08/22,20.0,,4213.1, jar save daily,1,"[list([('jar save daily', 98.03861898739333), ('jar save', 98.03682857485501), ('save daily', 98.03586853418446), ('delight paytm', 3.920523474443698), ('country delight', 3.9147386407433222)])]"
91,23/08/22,UPI-NARESH PUROHIT-NP1784534@OKHDFCBANK-HDFC0003522-223581125968-UPI,0000223581125968,23/08/22,218.0,,3995.1, naresh purohit np,4,"[list([('naresh purohit', 11.170927092504018), ('purohit np', 11.167440746173527), ('naresh purohit np', 11.166542020373829), ('gagan pan', 0.13119500953407723), ('pan shop', 0.1307016139459496)])]"
92,24/08/22,UPI-JAR  SAVE DAILY-JARMYJARONLINE@YBL-YESB0YBLUPI-223600408301-SUBSCRIPTION DEBIT,0000223600408301,24/08/22,25.0,,3970.1, jar save daily,1,"[list([('jar save daily', 98.03861898739333), ('jar save', 98.03682857485501), ('save daily', 98.03586853418446), ('delight paytm', 3.920523474443698), ('country delight', 3.9147386407433222)])]"
93,25/08/22,UPI-JAR  SAVE DAILY-JARMYJARONLINE@YBL-YESB0YBLUPI-223716622024-SUBSCRIPTION DEBIT,0000223716622024,25/08/22,20.0,,3950.1, jar save daily,1,"[list([('jar save daily', 98.03861898739333), ('jar save', 98.03682857485501), ('save daily', 98.03586853418446), ('delight paytm', 3.920523474443698), ('country delight', 3.9147386407433222)])]"
94,26/08/22,UPI-JAR  SAVE DAILY-JARMYJARONLINE@YBL-YESB0YBLUPI-223831507502-SUBSCRIPTION DEBIT,0000223831507502,26/08/22,20.0,,3930.1, jar save daily,1,"[list([('jar save daily', 98.03861898739333), ('jar save', 98.03682857485501), ('save daily', 98.03586853418446), ('delight paytm', 3.920523474443698), ('country delight', 3.9147386407433222)])]"
95,27/08/22,UPI-JAR  SAVE DAILY-JARMYJARONLINE@YBL-YESB0YBLUPI-223923960164-SUBSCRIPTION DEBIT,0000223923960164,27/08/22,30.0,,3900.1, jar save daily,1,"[list([('jar save daily', 98.03861898739333), ('jar save', 98.03682857485501), ('save daily', 98.03586853418446), ('delight paytm', 3.920523474443698), ('country delight', 3.9147386407433222)])]"
96,27/08/22,UPI-COUNTRY DELIGHT-PAYTM-31857153@PAYTM-PYTM0123456-223959452980-COUNTRY DELIGHT,0000223959452980,27/08/22,500.0,,3400.1, country delight paytm,1,"[list([('jar save daily', 98.03861898739333), ('jar save', 98.03682857485501), ('save daily', 98.03586853418446), ('delight paytm', 3.920523474443698), ('country delight', 3.9147386407433222)])]"
97,27/08/22,UPI-RAHUL-BHARATPE.90058100142@FBPE-FDRL0001382-223959740873-PAY TO BHARATPE ME,0000223959740873,27/08/22,60.0,,3340.1, rahul bharatpe ,8,"[list([('sumit mohan', 4.505268486902978), ('mohan gupta', 4.504494554311667), ('sumit mohan gupta', 4.502622451115006), ('jiofiber jiofiber', 2.613046376779851), ('olamoney razorpay', 1.7976716994787716)])]"
98,27/08/22,UPI-AEML-AWSP3@IDFCBANK-IDFB0040101-223963178512-UPI,0000223963178512,27/08/22,1090.0,,2250.1, aeml awsp ,3,"[list([('hungerbox paytm', 13.174251604078895), ('aeml awsp', 3.595276358492651), ('ccavenues ccavenues', 2.5585233143451727), ('premji paytmqr', 1.5287022749836985), ('patel premji paytmqr', 1.5276871161621721)])]"
99,28/08/22,UPI-JAR  SAVE DAILY-JARMYJARONLINE@YBL-YESB0YBLUPI-224053573869-SUBSCRIPTION DEBIT,0000224053573869,28/08/22,20.0,,2230.1, jar save daily,1,"[list([('jar save daily', 98.03861898739333), ('jar save', 98.03682857485501), ('save daily', 98.03586853418446), ('delight paytm', 3.920523474443698), ('country delight', 3.9147386407433222)])]"
100,29/08/22,UPI-JAR  SAVE DAILY-JARMYJARONLINE@YBL-YESB0YBLUPI-224109821693-SUBSCRIPTION DEBIT,0000224109821693,29/08/22,40.0,,2190.1, jar save daily,1,"[list([('jar save daily', 98.03861898739333), ('jar save', 98.03682857485501), ('save daily', 98.03586853418446), ('delight paytm', 3.920523474443698), ('country delight', 3.9147386407433222)])]"
101,29/08/22,UPI-PREMJIRAMJIPATEL-Q897899818@YBL-YESB0YBLUPI-224115014009-UPI,0000224115014009,29/08/22,15.0,,2175.1, premjiramjipatel q ,0,"[list([('aayushi super', 10.865290481053918), ('super shoppy', 10.865173862517079), ('aayushi super shoppy', 10.864427223847468), ('pos xxxxxx', 2.4550385779352015), ('ikea india', 1.609971068597172)])]"
102,30/08/22,UPI-JAR  SAVE DAILY-JARMYJARONLINE@YBL-YESB0YBLUPI-224270976788-SUBSCRIPTION DEBIT,0000224270976788,30/08/22,20.0,,2155.1, jar save daily,1,"[list([('jar save daily', 98.03861898739333), ('jar save', 98.03682857485501), ('save daily', 98.03586853418446), ('delight paytm', 3.920523474443698), ('country delight', 3.9147386407433222)])]"
104,31/08/22,UPI-JAR  SAVE DAILY-JARMYJARONLINE@YBL-YESB0YBLUPI-224359943379-SUBSCRIPTION DEBIT,0000224359943379,31/08/22,25.0,,73428.1, jar save daily,1,"[list([('jar save daily', 98.03861898739333), ('jar save', 98.03682857485501), ('save daily', 98.03586853418446), ('delight paytm', 3.920523474443698), ('country delight', 3.9147386407433222)])]"
105,31/08/22,UPI-CRED-CRED.CCBP@YESBANK-YESB0000022-224311381636-PAYMENT ON CRED,0000224311381636,31/08/22,20313.0,,53115.1, cred cred ccbp,0,"[list([('aayushi super', 10.865290481053918), ('super shoppy', 10.865173862517079), ('aayushi super shoppy', 10.864427223847468), ('pos xxxxxx', 2.4550385779352015), ('ikea india', 1.609971068597172)])]"
106,31/08/22,UPI-CREDCLUB-CREDCLUB@ICICI-ICIC0DC0099-224311744794-PAYMENT ON CRED,0000224311744794,31/08/22,1182.36,,51932.74, credclub credclub,0,"[list([('aayushi super', 10.865290481053918), ('super shoppy', 10.865173862517079), ('aayushi super shoppy', 10.864427223847468), ('pos xxxxxx', 2.4550385779352015), ('ikea india', 1.609971068597172)])]"
107,31/08/22,UPI-NARESH PUROHIT-NP1784534@OKHDFCBANK-HDFC0003522-224351304096-UPI,0000224351304096,31/08/22,190.0,,51742.74, naresh purohit np,4,"[list([('naresh purohit', 11.170927092504018), ('purohit np', 11.167440746173527), ('naresh purohit np', 11.166542020373829), ('gagan pan', 0.13119500953407723), ('pan shop', 0.1307016139459496)])]"
108,31/08/22,UPI-SUMIT MOHAN GUPTA-SUMITMG@OKICICI-BARB0PANKIX-224351318005-EDUCATION LOAN,0000224351318005,31/08/22,25000.0,,26742.74, sumit mohan gupta,8,"[list([('sumit mohan', 4.505268486902978), ('mohan gupta', 4.504494554311667), ('sumit mohan gupta', 4.502622451115006), ('jiofiber jiofiber', 2.613046376779851), ('olamoney razorpay', 1.7976716994787716)])]"
109,01/09/22,UPI-JAR  SAVE DAILY-JARMYJARONLINE@YBL-YESB0YBLUPI-224451170831-SUBSCRIPTION DEBIT,0000224451170831,01/09/22,20.0,,26722.74, jar save daily,1,"[list([('jar save daily', 98.03861898739333), ('jar save', 98.03682857485501), ('save daily', 98.03586853418446), ('delight paytm', 3.920523474443698), ('country delight', 3.9147386407433222)])]"
110,01/09/22,UPI-JIOFIBER-JIOFIBER@YESBANK-YESB0000248-224469965796-JIO20TB00001YMT0H0,0000224469965796,01/09/22,824.82,,25897.92, jiofiber jiofiber,8,"[list([('sumit mohan', 4.505268486902978), ('mohan gupta', 4.504494554311667), ('sumit mohan gupta', 4.502622451115006), ('jiofiber jiofiber', 2.613046376779851), ('olamoney razorpay', 1.7976716994787716)])]"
111,01/09/22,UPI-NARESH PUROHIT-NP1784534@OKHDFCBANK-HDFC0003522-224481338309-UPI,0000224481338309,01/09/22,58.0,,25839.92, naresh purohit np,4,"[list([('naresh purohit', 11.170927092504018), ('purohit np', 11.167440746173527), ('naresh purohit np', 11.166542020373829), ('gagan pan', 0.13119500953407723), ('pan shop', 0.1307016139459496)])]"
112,01/09/22,UPI-NARESH PUROHIT-NP1784534@OKHDFCBANK-HDFC0003522-224481378628-UPI,0000224481378628,01/09/22,10.0,,25829.92, naresh purohit np,4,"[list([('naresh purohit', 11.170927092504018), ('purohit np', 11.167440746173527), ('naresh purohit np', 11.166542020373829), ('gagan pan', 0.13119500953407723), ('pan shop', 0.1307016139459496)])]"
114,02/09/22,UPI-JAR  SAVE DAILY-JARMYJARONLINE@YBL-YESB0YBLUPI-224568927684-SUBSCRIPTION DEBIT,0000224568927684,02/09/22,40.0,,25790.92, jar save daily,1,"[list([('jar save daily', 98.03861898739333), ('jar save', 98.03682857485501), ('save daily', 98.03586853418446), ('delight paytm', 3.920523474443698), ('country delight', 3.9147386407433222)])]"
116,02/09/22,UPI-NARESH PUROHIT-NP1784534@OKHDFCBANK-HDFC0003522-224505961989-UPI,0000224505961989,02/09/22,20.0,,27174.31, naresh purohit np,4,"[list([('naresh purohit', 11.170927092504018), ('purohit np', 11.167440746173527), ('naresh purohit np', 11.166542020373829), ('gagan pan', 0.13119500953407723), ('pan shop', 0.1307016139459496)])]"
117,02/09/22,UPI-NARESH PUROHIT-NP1784534@OKHDFCBANK-HDFC0003522-224505975885-UPI,0000224505975885,02/09/22,20.0,,27154.31, naresh purohit np,4,"[list([('naresh purohit', 11.170927092504018), ('purohit np', 11.167440746173527), ('naresh purohit np', 11.166542020373829), ('gagan pan', 0.13119500953407723), ('pan shop', 0.1307016139459496)])]"
118,03/09/22,UPI-JAR  SAVE DAILY-JARMYJARONLINE@YBL-YESB0YBLUPI-224646973119-SUBSCRIPTION DEBIT,0000224646973119,03/09/22,37.0,,27117.31, jar save daily,1,"[list([('jar save daily', 98.03861898739333), ('jar save', 98.03682857485501), ('save daily', 98.03586853418446), ('delight paytm', 3.920523474443698), ('country delight', 3.9147386407433222)])]"
119,03/09/22,UPI-IKEA INDIA PVT LTD-IKEAINDIAPVTLTD.41509353@HDFCBANK-HDFC0000001-224626679765-UPI,0000224626679765,03/09/22,5190.0,,21927.31, ikea india pvt,0,"[list([('aayushi super', 10.865290481053918), ('super shoppy', 10.865173862517079), ('aayushi super shoppy', 10.864427223847468), ('pos xxxxxx', 2.4550385779352015), ('ikea india', 1.609971068597172)])]"
120,04/09/22,UPI-JAR  SAVE DAILY-JARMYJARONLINE@YBL-YESB0YBLUPI-224736239308-SUBSCRIPTION DEBIT,0000224736239308,04/09/22,40.0,,21887.31, jar save daily,1,"[list([('jar save daily', 98.03861898739333), ('jar save', 98.03682857485501), ('save daily', 98.03586853418446), ('delight paytm', 3.920523474443698), ('country delight', 3.9147386407433222)])]"
121,04/09/22,UPI-NARESH PUROHIT-NP1784534@OKHDFCBANK-HDFC0003522-224743469647-UPI,0000224743469647,04/09/22,56.0,,21831.31, naresh purohit np,4,"[list([('naresh purohit', 11.170927092504018), ('purohit np', 11.167440746173527), ('naresh purohit np', 11.166542020373829), ('gagan pan', 0.13119500953407723), ('pan shop', 0.1307016139459496)])]"
122,04/09/22,UPI-CCAVENUES-CCAVENUES@ICICI-ICIC0DC0099-224746713865-UPI,0000224746713865,04/09/22,3605.84,,18225.47, ccavenues ccavenues,3,"[list([('hungerbox paytm', 13.174251604078895), ('aeml awsp', 3.595276358492651), ('ccavenues ccavenues', 2.5585233143451727), ('premji paytmqr', 1.5287022749836985), ('patel premji paytmqr', 1.5276871161621721)])]"
123,05/09/22,UPI-JAR  SAVE DAILY-JARMYJARONLINE@YBL-YESB0YBLUPI-224831331562-SUBSCRIPTION DEBIT,0000224831331562,05/09/22,40.0,,18185.47, jar save daily,1,"[list([('jar save daily', 98.03861898739333), ('jar save', 98.03682857485501), ('save daily', 98.03586853418446), ('delight paytm', 3.920523474443698), ('country delight', 3.9147386407433222)])]"
124,05/09/22,DC 1019060021591624 AUTOPAY SI-TAD,0000000451958255,05/09/22,1788.89,,16396.58,dc autopay si tad,9,"[list([('si tad', 2.035923755867459), ('autopay si tad', 2.0352256901407024), ('autopay si', 2.0348731549436505), ('dc autopay si', 2.032376855832404), ('dc autopay', 2.0312507869052774)])]"
125,05/09/22,UPI-KRISHNA VEGETABLES A-PAYTMQR281005050101OGH9MJCCHZHN@PAYTM-PYTM0123456-224873735710-UPI,0000224873735710,05/09/22,25.0,,16371.58, krishna vegetables a,2,"[list([('gupta juice', 19.243605119465393), ('gupta juice center', 19.24314059509313), ('juice center', 19.241968449100682), ('krishna vegetables', 4.4101114348673125), ('cred club', 3.506991506858471)])]"
126,05/09/22,UPI-ASHOK LAXMAN PANSARE-PAYTMQR2810050501011QH1A2L7IS8G@PAYTM-PYTM0123456-224874350296-UPI,0000224874350296,05/09/22,15.0,,16356.58, ashok laxman pansare,0,"[list([('aayushi super', 10.865290481053918), ('super shoppy', 10.865173862517079), ('aayushi super shoppy', 10.864427223847468), ('pos xxxxxx', 2.4550385779352015), ('ikea india', 1.609971068597172)])]"
127,05/09/22,UPI-GAGAN PAN SHOP-PAYTMQR28100505010114WJI6OVAW2B@PAYTM-PYTM0123456-224874393603-UPI,0000224874393603,05/09/22,18.0,,16338.58, gagan pan shop,8,"[list([('sumit mohan', 4.505268486902978), ('mohan gupta', 4.504494554311667), ('sumit mohan gupta', 4.502622451115006), ('jiofiber jiofiber', 2.613046376779851), ('olamoney razorpay', 1.7976716994787716)])]"
128,06/09/22,UPI-JAR  SAVE DAILY-JARMYJARONLINE@YBL-YESB0YBLUPI-224968644353-SUBSCRIPTION DEBIT,0000224968644353,06/09/22,39.0,,16299.58, jar save daily,1,"[list([('jar save daily', 98.03861898739333), ('jar save', 98.03682857485501), ('save daily', 98.03586853418446), ('delight paytm', 3.920523474443698), ('country delight', 3.9147386407433222)])]"
129,07/09/22,UPI-JAR  SAVE DAILY-JARMYJARONLINE@YBL-YESB0YBLUPI-225060460656-SUBSCRIPTION DEBIT,0000225060460656,07/09/22,31.0,,16268.58, jar save daily,1,"[list([('jar save daily', 98.03861898739333), ('jar save', 98.03682857485501), ('save daily', 98.03586853418446), ('delight paytm', 3.920523474443698), ('country delight', 3.9147386407433222)])]"
130,07/09/22,UPI-NARESH PUROHIT-NP1784534@OKHDFCBANK-HDFC0003522-225011073285-UPI,0000225011073285,07/09/22,50.0,,16218.58, naresh purohit np,4,"[list([('naresh purohit', 11.170927092504018), ('purohit np', 11.167440746173527), ('naresh purohit np', 11.166542020373829), ('gagan pan', 0.13119500953407723), ('pan shop', 0.1307016139459496)])]"
131,08/09/22,UPI-JAR  SAVE DAILY-JARMYJARONLINE@YBL-YESB0YBLUPI-225164009625-SUBSCRIPTION DEBIT,0000225164009625,08/09/22,25.0,,16193.58, jar save daily,1,"[list([('jar save daily', 98.03861898739333), ('jar save', 98.03682857485501), ('save daily', 98.03586853418446), ('delight paytm', 3.920523474443698), ('country delight', 3.9147386407433222)])]"
132,08/09/22,UPI-SAINATH PAN BIDI SHO-PAYTMQR28100505010119BYX9JLSZUS@PAYTM-PYTM0123456-225144175247-UPI,0000225144175247,08/09/22,18.0,,16175.58, sainath pan bidi,0,"[list([('aayushi super', 10.865290481053918), ('super shoppy', 10.865173862517079), ('aayushi super shoppy', 10.864427223847468), ('pos xxxxxx', 2.4550385779352015), ('ikea india', 1.609971068597172)])]"
133,09/09/22,UPI-JAR  SAVE DAILY-JARMYJARONLINE@YBL-YESB0YBLUPI-225295070634-SUBSCRIPTION DEBIT,0000225295070634,09/09/22,30.0,,16145.58, jar save daily,1,"[list([('jar save daily', 98.03861898739333), ('jar save', 98.03682857485501), ('save daily', 98.03586853418446), ('delight paytm', 3.920523474443698), ('country delight', 3.9147386407433222)])]"
134,10/09/22,UPI-JAR  SAVE DAILY-JARMYJARONLINE@YBL-YESB0YBLUPI-225326083961-SUBSCRIPTION DEBIT,0000225326083961,10/09/22,20.0,,16125.58, jar save daily,1,"[list([('jar save daily', 98.03861898739333), ('jar save', 98.03682857485501), ('save daily', 98.03586853418446), ('delight paytm', 3.920523474443698), ('country delight', 3.9147386407433222)])]"
135,10/09/22,UPI-RAHUL-BHARATPE.90058100142@FBPE-FDRL0001382-225371080231-PAY TO BHARATPE ME,0000225371080231,10/09/22,170.0,,15955.58, rahul bharatpe ,8,"[list([('sumit mohan', 4.505268486902978), ('mohan gupta', 4.504494554311667), ('sumit mohan gupta', 4.502622451115006), ('jiofiber jiofiber', 2.613046376779851), ('olamoney razorpay', 1.7976716994787716)])]"
137,11/09/22,UPI-JAR  SAVE DAILY-JARMYJARONLINE@YBL-YESB0YBLUPI-225478728936-SUBSCRIPTION DEBIT,0000225478728936,11/09/22,20.0,,16268.58, jar save daily,1,"[list([('jar save daily', 98.03861898739333), ('jar save', 98.03682857485501), ('save daily', 98.03586853418446), ('delight paytm', 3.920523474443698), ('country delight', 3.9147386407433222)])]"
138,12/09/22,50400264425075- RD INSTALLMENT-SEP 2022,000000000000000,11/09/22,1400.0,,14868.58, rd installment sep,5,"[list([('rd installment', 5.604710649033009), ('shantidhan stores', 2.7402329765419635), ('stores gpay', 2.7390542080882083), ('shantidhan stores gpay', 2.7366626902016304), ('installment dec', 2.0266108955371855)])]"
139,12/09/22,UPI-JAR  SAVE DAILY-JARMYJARONLINE@YBL-YESB0YBLUPI-225571936073-SUBSCRIPTION DEBIT,0000225571936073,12/09/22,31.0,,14837.58, jar save daily,1,"[list([('jar save daily', 98.03861898739333), ('jar save', 98.03682857485501), ('save daily', 98.03586853418446), ('delight paytm', 3.920523474443698), ('country delight', 3.9147386407433222)])]"
140,13/09/22,UPI-JAR  SAVE DAILY-JARMYJARONLINE@YBL-YESB0YBLUPI-225663737446-SUBSCRIPTION DEBIT,0000225663737446,13/09/22,28.0,,14809.58, jar save daily,1,"[list([('jar save daily', 98.03861898739333), ('jar save', 98.03682857485501), ('save daily', 98.03586853418446), ('delight paytm', 3.920523474443698), ('country delight', 3.9147386407433222)])]"
141,13/09/22,UPI-MD DILSHAD ALAM-PAYTMQR281005050101NX01RVOSL1C9@PAYTM-PYTM0123456-225645282393-UPI,0000225645282393,13/09/22,15.0,,14794.58, md dilshad alam,0,"[list([('aayushi super', 10.865290481053918), ('super shoppy', 10.865173862517079), ('aayushi super shoppy', 10.864427223847468), ('pos xxxxxx', 2.4550385779352015), ('ikea india', 1.609971068597172)])]"
142,13/09/22,UPI-KRISHNA VEGETABLES A-PAYTMQR2810050501011SB7D2XYQJBM@PAYTM-PYTM0123456-225656147852-UPI,0000225656147852,13/09/22,25.0,,14769.58, krishna vegetables a,2,"[list([('gupta juice', 19.243605119465393), ('gupta juice center', 19.24314059509313), ('juice center', 19.241968449100682), ('krishna vegetables', 4.4101114348673125), ('cred club', 3.506991506858471)])]"
143,14/09/22,50400269095673- RD INSTALLMENT-JUL 2022,000000000000000,13/09/22,10000.0,,4769.58, rd installment jul,7,"[list([('raj vegetables gpay', 4.360523938382696), ('vegetables gpay', 4.3601697153875785), ('raj vegetables', 4.359825827176104), ('stores paytmqr', 3.567746696089187), ('hair glow', 2.506362310298007)])]"
144,14/09/22,UPI-JAR  SAVE DAILY-JARMYJARONLINE@YBL-YESB0YBLUPI-225794592590-SUBSCRIPTION DEBIT,0000225794592590,14/09/22,40.0,,4729.58, jar save daily,1,"[list([('jar save daily', 98.03861898739333), ('jar save', 98.03682857485501), ('save daily', 98.03586853418446), ('delight paytm', 3.920523474443698), ('country delight', 3.9147386407433222)])]"
145,14/09/22,UPI-COUNTRY DELIGHT-PAYTM-31857153@PAYTM-PYTM0123456-225762850398-COUNTRY DELIGHT,0000225762850398,14/09/22,1500.0,,3229.58, country delight paytm,1,"[list([('jar save daily', 98.03861898739333), ('jar save', 98.03682857485501), ('save daily', 98.03586853418446), ('delight paytm', 3.920523474443698), ('country delight', 3.9147386407433222)])]"
146,15/09/22,UPI-JAR  SAVE DAILY-JARMYJARONLINE@YBL-YESB0YBLUPI-225809567168-SUBSCRIPTION DEBIT,0000225809567168,15/09/22,40.0,,3189.58, jar save daily,1,"[list([('jar save daily', 98.03861898739333), ('jar save', 98.03682857485501), ('save daily', 98.03586853418446), ('delight paytm', 3.920523474443698), ('country delight', 3.9147386407433222)])]"
147,15/09/22,UPI-NARESH PUROHIT-NP1784534@OKHDFCBANK-HDFC0003522-225899932458-UPI,0000225899932458,15/09/22,40.0,,3149.58, naresh purohit np,4,"[list([('naresh purohit', 11.170927092504018), ('purohit np', 11.167440746173527), ('naresh purohit np', 11.166542020373829), ('gagan pan', 0.13119500953407723), ('pan shop', 0.1307016139459496)])]"
148,16/09/22,UPI-JAR  SAVE DAILY-JARMYJARONLINE@YBL-YESB0YBLUPI-225936179573-SUBSCRIPTION DEBIT,0000225936179573,16/09/22,40.0,,3109.58, jar save daily,1,"[list([('jar save daily', 98.03861898739333), ('jar save', 98.03682857485501), ('save daily', 98.03586853418446), ('delight paytm', 3.920523474443698), ('country delight', 3.9147386407433222)])]"
149,16/09/22,UPI-DUNZO DIGITAL PRIVAT-DUNZO.PAYU@HDFCBANK-HDFC0000499-225912639226-DUNZO ORDER,0000225912639226,16/09/22,110.0,,2999.58, dunzo digital privat,3,"[list([('hungerbox paytm', 13.174251604078895), ('aeml awsp', 3.595276358492651), ('ccavenues ccavenues', 2.5585233143451727), ('premji paytmqr', 1.5287022749836985), ('patel premji paytmqr', 1.5276871161621721)])]"
150,17/09/22,UPI-JAR  SAVE DAILY-JARMYJARONLINE@YBL-YESB0YBLUPI-226081257539-SUBSCRIPTION DEBIT,0000226081257539,17/09/22,36.0,,2963.58, jar save daily,1,"[list([('jar save daily', 98.03861898739333), ('jar save', 98.03682857485501), ('save daily', 98.03586853418446), ('delight paytm', 3.920523474443698), ('country delight', 3.9147386407433222)])]"
151,18/09/22,UPI-SWIGGY-SWIGGY@YESPAY-YESB0YESUPI-226166753700-PAY FOR MERCHANT,0000226166753700,18/09/22,308.0,,2655.58, swiggy swiggy,0,"[list([('aayushi super', 10.865290481053918), ('super shoppy', 10.865173862517079), ('aayushi super shoppy', 10.864427223847468), ('pos xxxxxx', 2.4550385779352015), ('ikea india', 1.609971068597172)])]"
154,19/09/22,UPI-NARESH PUROHIT-NP1784534@OKHDFCBANK-HDFC0003522-226284775737-UPI,0000226284775737,19/09/22,140.0,,3923.58, naresh purohit np,4,"[list([('naresh purohit', 11.170927092504018), ('purohit np', 11.167440746173527), ('naresh purohit np', 11.166542020373829), ('gagan pan', 0.13119500953407723), ('pan shop', 0.1307016139459496)])]"
155,19/09/22,UPI-JAR  SAVE DAILY-JARMYJARONLINE@YBL-YESB0YBLUPI-226233099369-SUBSCRIPTION DEBIT,0000226233099369,19/09/22,30.0,,3893.58, jar save daily,1,"[list([('jar save daily', 98.03861898739333), ('jar save', 98.03682857485501), ('save daily', 98.03586853418446), ('delight paytm', 3.920523474443698), ('country delight', 3.9147386407433222)])]"
156,20/09/22,UPI-JAR  SAVE DAILY-JARMYJARONLINE@YBL-YESB0YBLUPI-226355653002-SUBSCRIPTION DEBIT,0000226355653002,20/09/22,40.0,,3853.58, jar save daily,1,"[list([('jar save daily', 98.03861898739333), ('jar save', 98.03682857485501), ('save daily', 98.03586853418446), ('delight paytm', 3.920523474443698), ('country delight', 3.9147386407433222)])]"
157,21/09/22,UPI-JAR  SAVE DAILY-JARMYJARONLINE@YBL-YESB0YBLUPI-226452389602-SUBSCRIPTION DEBIT,0000226452389602,21/09/22,40.0,,3813.58, jar save daily,1,"[list([('jar save daily', 98.03861898739333), ('jar save', 98.03682857485501), ('save daily', 98.03586853418446), ('delight paytm', 3.920523474443698), ('country delight', 3.9147386407433222)])]"
158,22/09/22,UPI-JAR  SAVE DAILY-JARMYJARONLINE@YBL-YESB0YBLUPI-226501938267-SUBSCRIPTION DEBIT,0000226501938267,22/09/22,25.0,,3788.58, jar save daily,1,"[list([('jar save daily', 98.03861898739333), ('jar save', 98.03682857485501), ('save daily', 98.03586853418446), ('delight paytm', 3.920523474443698), ('country delight', 3.9147386407433222)])]"
159,23/09/22,UPI-JAR  SAVE DAILY-JARMYJARONLINE@YBL-YESB0YBLUPI-226614761216-SUBSCRIPTION DEBIT,0000226614761216,23/09/22,27.0,,3761.58, jar save daily,1,"[list([('jar save daily', 98.03861898739333), ('jar save', 98.03682857485501), ('save daily', 98.03586853418446), ('delight paytm', 3.920523474443698), ('country delight', 3.9147386407433222)])]"
162,23/09/22,UPI-NARESH PUROHIT-NP1784534@OKHDFCBANK-HDFC0003522-226670439069-UPI,0000226670439069,23/09/22,70.0,,23692.58, naresh purohit np,4,"[list([('naresh purohit', 11.170927092504018), ('purohit np', 11.167440746173527), ('naresh purohit np', 11.166542020373829), ('gagan pan', 0.13119500953407723), ('pan shop', 0.1307016139459496)])]"
163,24/09/22,UPI-JAR  SAVE DAILY-JARMYJARONLINE@YBL-YESB0YBLUPI-226780622331-SUBSCRIPTION DEBIT,0000226780622331,24/09/22,20.0,,23672.58, jar save daily,1,"[list([('jar save daily', 98.03861898739333), ('jar save', 98.03682857485501), ('save daily', 98.03586853418446), ('delight paytm', 3.920523474443698), ('country delight', 3.9147386407433222)])]"
164,24/09/22,UPI-CREDCLUB1-CRED.CLUB@AXISB-UTIB0000114-226707391141-PAYMENT ON CRED,0000226707391141,24/09/22,20901.0,,2771.58, credclub cred club,2,"[list([('gupta juice', 19.243605119465393), ('gupta juice center', 19.24314059509313), ('juice center', 19.241968449100682), ('krishna vegetables', 4.4101114348673125), ('cred club', 3.506991506858471)])]"
166,24/09/22,POS 512967XXXXXX4210 MSW*ONESTOP RETA,0000000000601987,24/09/22,3722.0,,49049.58,pos xxxxxx msw onestop,6,"[list([('chemist paytmqr', 3.9972774836044023), ('tirupati chemist', 3.9967234821483877), ('tirupati chemist paytmqr', 3.9965107262676147), ('akash bhatt', 2.709151344546336), ('makemytrip makemytrip', 2.077909670466702)])]"
167,24/09/22,POS 512967XXXXXX4210 MSW*ONESTOP RETA,0000000000602638,24/09/22,1195.0,,47854.58,pos xxxxxx msw onestop,6,"[list([('chemist paytmqr', 3.9972774836044023), ('tirupati chemist', 3.9967234821483877), ('tirupati chemist paytmqr', 3.9965107262676147), ('akash bhatt', 2.709151344546336), ('makemytrip makemytrip', 2.077909670466702)])]"
168,24/09/22,UPI-SONA WINE MERCHANT-SONAWINEMERCHANT.99729961@HDFCBANK-HDFC0000001-226701670762-UPI,0000226701670762,24/09/22,1670.0,,46184.58, sona wine merchant,0,"[list([('aayushi super', 10.865290481053918), ('super shoppy', 10.865173862517079), ('aayushi super shoppy', 10.864427223847468), ('pos xxxxxx', 2.4550385779352015), ('ikea india', 1.609971068597172)])]"
169,25/09/22,UPI-JAR  SAVE DAILY-JARMYJARONLINE@YBL-YESB0YBLUPI-226888522828-SUBSCRIPTION DEBIT,0000226888522828,25/09/22,31.0,,46153.58, jar save daily,1,"[list([('jar save daily', 98.03861898739333), ('jar save', 98.03682857485501), ('save daily', 98.03586853418446), ('delight paytm', 3.920523474443698), ('country delight', 3.9147386407433222)])]"
170,25/09/22,UPI-AEML-AWSP3@IDFCBANK-IDFB0040101-226810174476-UPI,0000226810174476,25/09/22,1840.0,,44313.58, aeml awsp ,3,"[list([('hungerbox paytm', 13.174251604078895), ('aeml awsp', 3.595276358492651), ('ccavenues ccavenues', 2.5585233143451727), ('premji paytmqr', 1.5287022749836985), ('patel premji paytmqr', 1.5276871161621721)])]"
171,25/09/22,UPI-NARESH PUROHIT-NP1784534@OKHDFCBANK-HDFC0003522-226811232003-UPI,0000226811232003,25/09/22,218.0,,44095.58, naresh purohit np,4,"[list([('naresh purohit', 11.170927092504018), ('purohit np', 11.167440746173527), ('naresh purohit np', 11.166542020373829), ('gagan pan', 0.13119500953407723), ('pan shop', 0.1307016139459496)])]"
172,25/09/22,UPI-SUMIT MOHAN GUPTA-SUMITMG@OKICICI-BARB0PANKIX-226814980800-EDUCATION LOAN,0000226814980800,25/09/22,25000.0,,19095.58, sumit mohan gupta,8,"[list([('sumit mohan', 4.505268486902978), ('mohan gupta', 4.504494554311667), ('sumit mohan gupta', 4.502622451115006), ('jiofiber jiofiber', 2.613046376779851), ('olamoney razorpay', 1.7976716994787716)])]"
173,26/09/22,UPI-JAR  SAVE DAILY-JARMYJARONLINE@YBL-YESB0YBLUPI-226994364370-SUBSCRIPTION DEBIT,0000226994364370,26/09/22,39.0,,19056.58, jar save daily,1,"[list([('jar save daily', 98.03861898739333), ('jar save', 98.03682857485501), ('save daily', 98.03586853418446), ('delight paytm', 3.920523474443698), ('country delight', 3.9147386407433222)])]"
174,26/09/22,UPI-OLAMONEY1-OLAMONEY1.RAZORPAY@HDFCBANK-HDFC0000053-226937615940-UPI,0000226937615940,26/09/22,2240.0,,16816.58, olamoney olamoney razorpay,8,"[list([('sumit mohan', 4.505268486902978), ('mohan gupta', 4.504494554311667), ('sumit mohan gupta', 4.502622451115006), ('jiofiber jiofiber', 2.613046376779851), ('olamoney razorpay', 1.7976716994787716)])]"
175,27/09/22,UPI-JAR  SAVE DAILY-JARMYJARONLINE@YBL-YESB0YBLUPI-227043566472-SUBSCRIPTION DEBIT,0000227043566472,27/09/22,40.0,,16776.58, jar save daily,1,"[list([('jar save daily', 98.03861898739333), ('jar save', 98.03682857485501), ('save daily', 98.03586853418446), ('delight paytm', 3.920523474443698), ('country delight', 3.9147386407433222)])]"
176,28/09/22,UPI-JAR  SAVE DAILY-JARMYJARONLINE@YBL-YESB0YBLUPI-227106770332-SUBSCRIPTION DEBIT,0000227106770332,28/09/22,40.0,,16736.58, jar save daily,1,"[list([('jar save daily', 98.03861898739333), ('jar save', 98.03682857485501), ('save daily', 98.03586853418446), ('delight paytm', 3.920523474443698), ('country delight', 3.9147386407433222)])]"
177,28/09/22,UPI-NARESH PUROHIT-NP1784534@OKHDFCBANK-HDFC0003522-227193388337-UPI,0000227193388337,28/09/22,50.0,,16686.58, naresh purohit np,4,"[list([('naresh purohit', 11.170927092504018), ('purohit np', 11.167440746173527), ('naresh purohit np', 11.166542020373829), ('gagan pan', 0.13119500953407723), ('pan shop', 0.1307016139459496)])]"
178,29/09/22,UPI-JAR  SAVE DAILY-JARMYJARONLINE@YBL-YESB0YBLUPI-227271358760-SUBSCRIPTION DEBIT,0000227271358760,29/09/22,20.0,,16666.58, jar save daily,1,"[list([('jar save daily', 98.03861898739333), ('jar save', 98.03682857485501), ('save daily', 98.03586853418446), ('delight paytm', 3.920523474443698), ('country delight', 3.9147386407433222)])]"
179,30/09/22,UPI-JAR  SAVE DAILY-JARMYJARONLINE@YBL-YESB0YBLUPI-227365792999-SUBSCRIPTION DEBIT,0000227365792999,30/09/22,30.0,,16636.58, jar save daily,1,"[list([('jar save daily', 98.03861898739333), ('jar save', 98.03682857485501), ('save daily', 98.03586853418446), ('delight paytm', 3.920523474443698), ('country delight', 3.9147386407433222)])]"
184,01/10/22,UPI-JAR  SAVE DAILY-JARMYJARONLINE@YBL-YESB0YBLUPI-227477415306-SUBSCRIPTION DEBIT,0000227477415306,01/10/22,22.0,,18133.97, jar save daily,1,"[list([('jar save daily', 98.03861898739333), ('jar save', 98.03682857485501), ('save daily', 98.03586853418446), ('delight paytm', 3.920523474443698), ('country delight', 3.9147386407433222)])]"
185,02/10/22,UPI-JAR  SAVE DAILY-JARMYJARONLINE@YBL-YESB0YBLUPI-227531047595-SUBSCRIPTION DEBIT,0000227531047595,02/10/22,31.0,,18102.97, jar save daily,1,"[list([('jar save daily', 98.03861898739333), ('jar save', 98.03682857485501), ('save daily', 98.03586853418446), ('delight paytm', 3.920523474443698), ('country delight', 3.9147386407433222)])]"
187,03/10/22,UPI-JAR  SAVE DAILY-JARMYJARONLINE@YBL-YESB0YBLUPI-227630412076-SUBSCRIPTION DEBIT,0000227630412076,03/10/22,25.0,,18078.97, jar save daily,1,"[list([('jar save daily', 98.03861898739333), ('jar save', 98.03682857485501), ('save daily', 98.03586853418446), ('delight paytm', 3.920523474443698), ('country delight', 3.9147386407433222)])]"
188,04/10/22,UPI-JAR  SAVE DAILY-JARMYJARONLINE@YBL-YESB0YBLUPI-227775476737-SUBSCRIPTION DEBIT,0000227775476737,04/10/22,27.0,,18051.97, jar save daily,1,"[list([('jar save daily', 98.03861898739333), ('jar save', 98.03682857485501), ('save daily', 98.03586853418446), ('delight paytm', 3.920523474443698), ('country delight', 3.9147386407433222)])]"
189,05/10/22,UPI-JAR  SAVE DAILY-JARMYJARONLINE@YBL-YESB0YBLUPI-227849930350-SUBSCRIPTION DEBIT,0000227849930350,05/10/22,30.0,,18021.97, jar save daily,1,"[list([('jar save daily', 98.03861898739333), ('jar save', 98.03682857485501), ('save daily', 98.03586853418446), ('delight paytm', 3.920523474443698), ('country delight', 3.9147386407433222)])]"
190,05/10/22,DC 1019060021591624 AUTOPAY SI-TAD,0000000458593345,05/10/22,1788.89,,16233.08,dc autopay si tad,9,"[list([('si tad', 2.035923755867459), ('autopay si tad', 2.0352256901407024), ('autopay si', 2.0348731549436505), ('dc autopay si', 2.032376855832404), ('dc autopay', 2.0312507869052774)])]"
191,06/10/22,UPI-JAR  SAVE DAILY-JARMYJARONLINE@YBL-YESB0YBLUPI-227925517019-SUBSCRIPTION DEBIT,0000227925517019,06/10/22,38.0,,16195.08, jar save daily,1,"[list([('jar save daily', 98.03861898739333), ('jar save', 98.03682857485501), ('save daily', 98.03586853418446), ('delight paytm', 3.920523474443698), ('country delight', 3.9147386407433222)])]"
192,06/10/22,UPI-JIOFIBER-JIOFIBER@YESBANK-YESB0000248-227972308113-JIO20TB000023CTH40,0000227972308113,06/10/22,2474.46,,13720.62, jiofiber jiofiber,8,"[list([('sumit mohan', 4.505268486902978), ('mohan gupta', 4.504494554311667), ('sumit mohan gupta', 4.502622451115006), ('jiofiber jiofiber', 2.613046376779851), ('olamoney razorpay', 1.7976716994787716)])]"
193,07/10/22,UPI-JAR  SAVE DAILY-JARMYJARONLINE@YBL-YESB0YBLUPI-228019857257-SUBSCRIPTION DEBIT,0000228019857257,07/10/22,20.0,,13700.62, jar save daily,1,"[list([('jar save daily', 98.03861898739333), ('jar save', 98.03682857485501), ('save daily', 98.03586853418446), ('delight paytm', 3.920523474443698), ('country delight', 3.9147386407433222)])]"
194,07/10/22,UPI-ADD MONEY TO WALLET-ADD-MONEY@PAYTM-PYTM0123456-228083949375-OID202210073697198,0000228083949375,07/10/22,787.0,,12913.62, add money to,0,"[list([('aayushi super', 10.865290481053918), ('super shoppy', 10.865173862517079), ('aayushi super shoppy', 10.864427223847468), ('pos xxxxxx', 2.4550385779352015), ('ikea india', 1.609971068597172)])]"
195,08/10/22,UPI-JAR  SAVE DAILY-JARMYJARONLINE@YBL-YESB0YBLUPI-228169215227-SUBSCRIPTION DEBIT,0000228169215227,08/10/22,20.0,,12893.62, jar save daily,1,"[list([('jar save daily', 98.03861898739333), ('jar save', 98.03682857485501), ('save daily', 98.03586853418446), ('delight paytm', 3.920523474443698), ('country delight', 3.9147386407433222)])]"
196,08/10/22,UPI-HAIR GLOW-9819103125@OKBIZAXIS-UTIB0000000-228119675797-UPI,0000228119675797,08/10/22,600.0,,12293.62, hair glow ,7,"[list([('raj vegetables gpay', 4.360523938382696), ('vegetables gpay', 4.3601697153875785), ('raj vegetables', 4.359825827176104), ('stores paytmqr', 3.567746696089187), ('hair glow', 2.506362310298007)])]"
197,08/10/22,UPI-TIF LABS PVT LTD-TIFLABS@KAYPAY-KKBK0000431-228128590465-PAYMENT FOR SHFYDQ,0000228128590465,08/10/22,1222.0,,11071.62, tif labs pvt,0,"[list([('aayushi super', 10.865290481053918), ('super shoppy', 10.865173862517079), ('aayushi super shoppy', 10.864427223847468), ('pos xxxxxx', 2.4550385779352015), ('ikea india', 1.609971068597172)])]"
198,08/10/22,UPI-RUDRA DEV SINGH-RUDRADEV123SINGH@OKSBI-SBIN0001183-228129463612-UPI,0000228129463612,08/10/22,100.0,,10971.62, rudra dev singh,0,"[list([('aayushi super', 10.865290481053918), ('super shoppy', 10.865173862517079), ('aayushi super shoppy', 10.864427223847468), ('pos xxxxxx', 2.4550385779352015), ('ikea india', 1.609971068597172)])]"
199,09/10/22,UPI-JAR  SAVE DAILY-JARMYJARONLINE@YBL-YESB0YBLUPI-228212804091-SUBSCRIPTION DEBIT,0000228212804091,09/10/22,26.0,,10945.62, jar save daily,1,"[list([('jar save daily', 98.03861898739333), ('jar save', 98.03682857485501), ('save daily', 98.03586853418446), ('delight paytm', 3.920523474443698), ('country delight', 3.9147386407433222)])]"
200,10/10/22,UPI-JAR  SAVE DAILY-JARMYJARONLINE@YBL-YESB0YBLUPI-228341070868-SUBSCRIPTION DEBIT,0000228341070868,10/10/22,40.0,,10905.62, jar save daily,1,"[list([('jar save daily', 98.03861898739333), ('jar save', 98.03682857485501), ('save daily', 98.03586853418446), ('delight paytm', 3.920523474443698), ('country delight', 3.9147386407433222)])]"
202,10/10/22,UPI-SUMIT MOHAN GUPTA-SUMITMG@OKICICI-BARB0PANKIX-228367833752-EDUCATION LOAN,0000228367833752,10/10/22,25000.0,,98539.62, sumit mohan gupta,8,"[list([('sumit mohan', 4.505268486902978), ('mohan gupta', 4.504494554311667), ('sumit mohan gupta', 4.502622451115006), ('jiofiber jiofiber', 2.613046376779851), ('olamoney razorpay', 1.7976716994787716)])]"
204,11/10/22,UPI-JAR  SAVE DAILY-JARMYJARONLINE@YBL-YESB0YBLUPI-228450688267-SUBSCRIPTION DEBIT,0000228450688267,11/10/22,20.0,,121169.62, jar save daily,1,"[list([('jar save daily', 98.03861898739333), ('jar save', 98.03682857485501), ('save daily', 98.03586853418446), ('delight paytm', 3.920523474443698), ('country delight', 3.9147386407433222)])]"
205,11/10/22,UPI-RAJENDRA KUMAR VISHN-RKVISHNOI-2@OKAXIS-HDFC0000298-228487302452-PERSONAL LOAN WAPI,0000228487302452,11/10/22,40000.0,,81169.62, rajendra kumar vishn,0,"[list([('aayushi super', 10.865290481053918), ('super shoppy', 10.865173862517079), ('aayushi super shoppy', 10.864427223847468), ('pos xxxxxx', 2.4550385779352015), ('ikea india', 1.609971068597172)])]"
206,11/10/22,UPI-OLA MONEY-OLAMONEY1.RZP@AXISBANK-UTIB0001507-228488725995-UPI,0000228488725995,11/10/22,116.0,,81053.62, ola money olamoney,9,"[list([('si tad', 2.035923755867459), ('autopay si tad', 2.0352256901407024), ('autopay si', 2.0348731549436505), ('dc autopay si', 2.032376855832404), ('dc autopay', 2.0312507869052774)])]"
207,12/10/22,50400264425075- RD INSTALLMENT-OCT 2022,000000000000000,11/10/22,1400.0,,79653.62, rd installment oct,5,"[list([('rd installment', 5.604710649033009), ('shantidhan stores', 2.7402329765419635), ('stores gpay', 2.7390542080882083), ('shantidhan stores gpay', 2.7366626902016304), ('installment dec', 2.0266108955371855)])]"
208,12/10/22,UPI-JAR  SAVE DAILY-JARMYJARONLINE@YBL-YESB0YBLUPI-228571290084-SUBSCRIPTION DEBIT,0000228571290084,12/10/22,30.0,,79623.62, jar save daily,1,"[list([('jar save daily', 98.03861898739333), ('jar save', 98.03682857485501), ('save daily', 98.03586853418446), ('delight paytm', 3.920523474443698), ('country delight', 3.9147386407433222)])]"
209,12/10/22,UPI-SHOPPING ZONE-9870566786@OKBIZAXIS-UTIB0000000-228507358780-UPI,0000228507358780,12/10/22,417.0,,79206.62, shopping zone ,0,"[list([('aayushi super', 10.865290481053918), ('super shoppy', 10.865173862517079), ('aayushi super shoppy', 10.864427223847468), ('pos xxxxxx', 2.4550385779352015), ('ikea india', 1.609971068597172)])]"
210,12/10/22,UPI-IDLI COM 1C 1-MSWIPE.1400101421000083@KOTAK-KKBK0000958-228513455233-UPI,0000228513455233,12/10/22,180.0,,79026.62, idli com c,0,"[list([('aayushi super', 10.865290481053918), ('super shoppy', 10.865173862517079), ('aayushi super shoppy', 10.864427223847468), ('pos xxxxxx', 2.4550385779352015), ('ikea india', 1.609971068597172)])]"
211,13/10/22,UPI-JAR  SAVE DAILY-JARMYJARONLINE@YBL-YESB0YBLUPI-228664274362-SUBSCRIPTION DEBIT,0000228664274362,13/10/22,38.0,,78988.62, jar save daily,1,"[list([('jar save daily', 98.03861898739333), ('jar save', 98.03682857485501), ('save daily', 98.03586853418446), ('delight paytm', 3.920523474443698), ('country delight', 3.9147386407433222)])]"
212,13/10/22,UPI-LIFE LINE PHARMACY-GPAY-11201766202@OKBIZAXIS-UTIB0000000-228645276051-UPI,0000228645276051,13/10/22,90.0,,78898.62, life line pharmacy,0,"[list([('aayushi super', 10.865290481053918), ('super shoppy', 10.865173862517079), ('aayushi super shoppy', 10.864427223847468), ('pos xxxxxx', 2.4550385779352015), ('ikea india', 1.609971068597172)])]"
213,14/10/22,50400269095673- RD INSTALLMENT-AUG 2022,000000000000000,13/10/22,10000.0,,68898.62, rd installment aug,8,"[list([('sumit mohan', 4.505268486902978), ('mohan gupta', 4.504494554311667), ('sumit mohan gupta', 4.502622451115006), ('jiofiber jiofiber', 2.613046376779851), ('olamoney razorpay', 1.7976716994787716)])]"
214,14/10/22,50400269095673- RD INSTALLMENT-SEP 2022,000000000000000,13/10/22,10000.0,,58898.62, rd installment sep,5,"[list([('rd installment', 5.604710649033009), ('shantidhan stores', 2.7402329765419635), ('stores gpay', 2.7390542080882083), ('shantidhan stores gpay', 2.7366626902016304), ('installment dec', 2.0266108955371855)])]"
215,14/10/22,50400269095673- RD INSTALLMENT-OCT 2022,000000000000000,13/10/22,10000.0,,48898.62, rd installment oct,5,"[list([('rd installment', 5.604710649033009), ('shantidhan stores', 2.7402329765419635), ('stores gpay', 2.7390542080882083), ('shantidhan stores gpay', 2.7366626902016304), ('installment dec', 2.0266108955371855)])]"
216,14/10/22,UPI-JAR  SAVE DAILY-JARMYJARONLINE@YBL-YESB0YBLUPI-228777898142-SUBSCRIPTION DEBIT,0000228777898142,14/10/22,30.0,,48868.62, jar save daily,1,"[list([('jar save daily', 98.03861898739333), ('jar save', 98.03682857485501), ('save daily', 98.03586853418446), ('delight paytm', 3.920523474443698), ('country delight', 3.9147386407433222)])]"
217,14/10/22,UPI-JAWED HABIB-GPAY-11171070670@OKBIZAXIS-UTIB0000000-228754472970-UPI,0000228754472970,14/10/22,300.0,,48568.62, jawed habib gpay,0,"[list([('aayushi super', 10.865290481053918), ('super shoppy', 10.865173862517079), ('aayushi super shoppy', 10.864427223847468), ('pos xxxxxx', 2.4550385779352015), ('ikea india', 1.609971068597172)])]"
218,15/10/22,UPI-JAR  SAVE DAILY-JARMYJARONLINE@YBL-YESB0YBLUPI-228834201386-SUBSCRIPTION DEBIT,0000228834201386,15/10/22,40.0,,48528.62, jar save daily,1,"[list([('jar save daily', 98.03861898739333), ('jar save', 98.03682857485501), ('save daily', 98.03586853418446), ('delight paytm', 3.920523474443698), ('country delight', 3.9147386407433222)])]"
219,15/10/22,POS 512967XXXXXX4210 RAHUL SWEET AND,0000000000013851,15/10/22,670.0,,47858.62,pos xxxxxx rahul sweet,0,"[list([('aayushi super', 10.865290481053918), ('super shoppy', 10.865173862517079), ('aayushi super shoppy', 10.864427223847468), ('pos xxxxxx', 2.4550385779352015), ('ikea india', 1.609971068597172)])]"
220,16/10/22,UPI-JAR  SAVE DAILY-JARMYJARONLINE@YBL-YESB0YBLUPI-228915266082-SUBSCRIPTION DEBIT,0000228915266082,16/10/22,40.0,,47818.62, jar save daily,1,"[list([('jar save daily', 98.03861898739333), ('jar save', 98.03682857485501), ('save daily', 98.03586853418446), ('delight paytm', 3.920523474443698), ('country delight', 3.9147386407433222)])]"
221,17/10/22,UPI-JAR  SAVE DAILY-JARMYJARONLINE@YBL-YESB0YBLUPI-229054494769-SUBSCRIPTION DEBIT,0000229054494769,17/10/22,30.0,,47788.62, jar save daily,1,"[list([('jar save daily', 98.03861898739333), ('jar save', 98.03682857485501), ('save daily', 98.03586853418446), ('delight paytm', 3.920523474443698), ('country delight', 3.9147386407433222)])]"
222,18/10/22,UPI-JAR  SAVE DAILY-JARMYJARONLINE@YBL-YESB0YBLUPI-229178679166-SUBSCRIPTION DEBIT,0000229178679166,18/10/22,21.0,,47767.62, jar save daily,1,"[list([('jar save daily', 98.03861898739333), ('jar save', 98.03682857485501), ('save daily', 98.03586853418446), ('delight paytm', 3.920523474443698), ('country delight', 3.9147386407433222)])]"
223,18/10/22,UPI-ARUN SHARMA DIAGNOST-GPAY-11186666287@OKBIZAXIS-UTIB0000000-229153975394-DOCTOR,0000229153975394,18/10/22,1500.0,,46267.62, arun sharma diagnost,0,"[list([('aayushi super', 10.865290481053918), ('super shoppy', 10.865173862517079), ('aayushi super shoppy', 10.864427223847468), ('pos xxxxxx', 2.4550385779352015), ('ikea india', 1.609971068597172)])]"
224,18/10/22,UPI-LIFE LINE PHARMACY-GPAY-11201766202@OKBIZAXIS-UTIB0000000-229157068579-UPI,0000229157068579,18/10/22,115.0,,46152.62, life line pharmacy,0,"[list([('aayushi super', 10.865290481053918), ('super shoppy', 10.865173862517079), ('aayushi super shoppy', 10.864427223847468), ('pos xxxxxx', 2.4550385779352015), ('ikea india', 1.609971068597172)])]"
226,19/10/22,UPI-JAR  SAVE DAILY-JARMYJARONLINE@YBL-YESB0YBLUPI-229222405894-SUBSCRIPTION DEBIT,0000229222405894,19/10/22,21.0,,46132.62, jar save daily,1,"[list([('jar save daily', 98.03861898739333), ('jar save', 98.03682857485501), ('save daily', 98.03586853418446), ('delight paytm', 3.920523474443698), ('country delight', 3.9147386407433222)])]"
227,19/10/22,POS 512967XXXXXX4210 SATNAM MOTORS,0000000000009395,19/10/22,1000.0,,45132.62,pos xxxxxx satnam motors,0,"[list([('aayushi super', 10.865290481053918), ('super shoppy', 10.865173862517079), ('aayushi super shoppy', 10.864427223847468), ('pos xxxxxx', 2.4550385779352015), ('ikea india', 1.609971068597172)])]"
228,20/10/22,UPI-JAR  SAVE DAILY-JARMYJARONLINE@YBL-YESB0YBLUPI-229384245024-SUBSCRIPTION DEBIT,0000229384245024,20/10/22,30.0,,45102.62, jar save daily,1,"[list([('jar save daily', 98.03861898739333), ('jar save', 98.03682857485501), ('save daily', 98.03586853418446), ('delight paytm', 3.920523474443698), ('country delight', 3.9147386407433222)])]"
229,20/10/22,UPI-SURAJ PRASAD S O SHI-SURAJPRASAD8580@OKSBI-BARB0KABARI-229300088079-UPI,0000229300088079,20/10/22,218.0,,44884.62, suraj prasad s,0,"[list([('aayushi super', 10.865290481053918), ('super shoppy', 10.865173862517079), ('aayushi super shoppy', 10.864427223847468), ('pos xxxxxx', 2.4550385779352015), ('ikea india', 1.609971068597172)])]"
230,21/10/22,UPI-JAR  SAVE DAILY-JARMYJARONLINE@YBL-YESB0YBLUPI-229486195978-SUBSCRIPTION DEBIT,0000229486195978,21/10/22,21.0,,44863.62, jar save daily,1,"[list([('jar save daily', 98.03861898739333), ('jar save', 98.03682857485501), ('save daily', 98.03586853418446), ('delight paytm', 3.920523474443698), ('country delight', 3.9147386407433222)])]"
231,22/10/22,UPI-JAR  SAVE DAILY-JARMYJARONLINE@YBL-YESB0YBLUPI-229537087378-SUBSCRIPTION DEBIT,0000229537087378,22/10/22,22.0,,44841.62, jar save daily,1,"[list([('jar save daily', 98.03861898739333), ('jar save', 98.03682857485501), ('save daily', 98.03586853418446), ('delight paytm', 3.920523474443698), ('country delight', 3.9147386407433222)])]"
232,22/10/22,UPI-SUMIT MOHAN GUPTA-7379543866@JUPITERAXIS-FDRL0007777-229519342700-ADDMONEY,0000229519342700,22/10/22,10000.0,,34841.62, sumit mohan gupta,8,"[list([('sumit mohan', 4.505268486902978), ('mohan gupta', 4.504494554311667), ('sumit mohan gupta', 4.502622451115006), ('jiofiber jiofiber', 2.613046376779851), ('olamoney razorpay', 1.7976716994787716)])]"
233,23/10/22,UPI-JAR  SAVE DAILY-JARMYJARONLINE@YBL-YESB0YBLUPI-229650424595-SUBSCRIPTION DEBIT,0000229650424595,23/10/22,20.0,,34821.62, jar save daily,1,"[list([('jar save daily', 98.03861898739333), ('jar save', 98.03682857485501), ('save daily', 98.03586853418446), ('delight paytm', 3.920523474443698), ('country delight', 3.9147386407433222)])]"
234,23/10/22,UPI-SHIVAM KUMAR-SKGAUTAM13798@OKICICI-BKID0007291-229677054208-UPI,0000229677054208,23/10/22,9000.0,,25821.62, shivam kumar skgautam,0,"[list([('aayushi super', 10.865290481053918), ('super shoppy', 10.865173862517079), ('aayushi super shoppy', 10.864427223847468), ('pos xxxxxx', 2.4550385779352015), ('ikea india', 1.609971068597172)])]"
235,23/10/22,UPI-AKASH BHATT-7081617363@PAYTM-PYTM0123456-229677881313-UPI,0000229677881313,23/10/22,190.0,,25631.62, akash bhatt ,6,"[list([('chemist paytmqr', 3.9972774836044023), ('tirupati chemist', 3.9967234821483877), ('tirupati chemist paytmqr', 3.9965107262676147), ('akash bhatt', 2.709151344546336), ('makemytrip makemytrip', 2.077909670466702)])]"
236,23/10/22,UPI-AKASH BHATT-7081617363@PAYTM-PYTM0123456-229678027211-UPI,0000229678027211,23/10/22,340.0,,25291.62, akash bhatt ,6,"[list([('chemist paytmqr', 3.9972774836044023), ('tirupati chemist', 3.9967234821483877), ('tirupati chemist paytmqr', 3.9965107262676147), ('akash bhatt', 2.709151344546336), ('makemytrip makemytrip', 2.077909670466702)])]"
237,24/10/22,UPI-JAR  SAVE DAILY-JARMYJARONLINE@YBL-YESB0YBLUPI-229728950700-SUBSCRIPTION DEBIT,0000229728950700,24/10/22,30.0,,25261.62, jar save daily,1,"[list([('jar save daily', 98.03861898739333), ('jar save', 98.03682857485501), ('save daily', 98.03586853418446), ('delight paytm', 3.920523474443698), ('country delight', 3.9147386407433222)])]"
238,25/10/22,UPI-JAR  SAVE DAILY-JARMYJARONLINE@YBL-YESB0YBLUPI-229858222703-SUBSCRIPTION DEBIT,0000229858222703,25/10/22,40.0,,25221.62, jar save daily,1,"[list([('jar save daily', 98.03861898739333), ('jar save', 98.03682857485501), ('save daily', 98.03586853418446), ('delight paytm', 3.920523474443698), ('country delight', 3.9147386407433222)])]"
239,25/10/22,UPI-AKASH BHATT-7081617363@PAYTM-PYTM0123456-229813211361-UPI,0000229813211361,25/10/22,915.0,,24306.62, akash bhatt ,6,"[list([('chemist paytmqr', 3.9972774836044023), ('tirupati chemist', 3.9967234821483877), ('tirupati chemist paytmqr', 3.9965107262676147), ('akash bhatt', 2.709151344546336), ('makemytrip makemytrip', 2.077909670466702)])]"
240,26/10/22,UPI-JAR  SAVE DAILY-JARMYJARONLINE@YBL-YESB0YBLUPI-229939950058-SUBSCRIPTION DEBIT,0000229939950058,26/10/22,30.0,,24276.62, jar save daily,1,"[list([('jar save daily', 98.03861898739333), ('jar save', 98.03682857485501), ('save daily', 98.03586853418446), ('delight paytm', 3.920523474443698), ('country delight', 3.9147386407433222)])]"
241,26/10/22,UPI-VODAFONE IDEA LIMITE-VIPREVF@HSBC-HSBC0400002-229925778703-UPI,0000229925778703,26/10/22,666.0,,23610.62, vodafone idea limite,0,"[list([('aayushi super', 10.865290481053918), ('super shoppy', 10.865173862517079), ('aayushi super shoppy', 10.864427223847468), ('pos xxxxxx', 2.4550385779352015), ('ikea india', 1.609971068597172)])]"
242,27/10/22,UPI-JAR  SAVE DAILY-JARMYJARONLINE@YBL-YESB0YBLUPI-230056476462-SUBSCRIPTION DEBIT,0000230056476462,27/10/22,25.0,,23585.62, jar save daily,1,"[list([('jar save daily', 98.03861898739333), ('jar save', 98.03682857485501), ('save daily', 98.03586853418446), ('delight paytm', 3.920523474443698), ('country delight', 3.9147386407433222)])]"
243,27/10/22,UPI-IBIBO GROUP PRIVATE -REDBUS1.GPAYONLINE@AXISBANK-UTIB0000553-230048498031-UPI,0000230048498031,27/10/22,7767.9,,15817.72, ibibo group private,0,"[list([('aayushi super', 10.865290481053918), ('super shoppy', 10.865173862517079), ('aayushi super shoppy', 10.864427223847468), ('pos xxxxxx', 2.4550385779352015), ('ikea india', 1.609971068597172)])]"
244,27/10/22,UPI-LIFE LINE PHARMACY-GPAY-11201766202@OKBIZAXIS-UTIB0000000-230056291243-UPI,0000230056291243,27/10/22,30.0,,15787.72, life line pharmacy,0,"[list([('aayushi super', 10.865290481053918), ('super shoppy', 10.865173862517079), ('aayushi super shoppy', 10.864427223847468), ('pos xxxxxx', 2.4550385779352015), ('ikea india', 1.609971068597172)])]"
245,28/10/22,UPI-JAR  SAVE DAILY-JARMYJARONLINE@YBL-YESB0YBLUPI-230136234043-SUBSCRIPTION DEBIT,0000230136234043,28/10/22,27.0,,15760.72, jar save daily,1,"[list([('jar save daily', 98.03861898739333), ('jar save', 98.03682857485501), ('save daily', 98.03586853418446), ('delight paytm', 3.920523474443698), ('country delight', 3.9147386407433222)])]"
247,28/10/22,UPI-BHARTI AIRTEL LIMITE-AIRTEL.PAYU@HDFCBANK-HDFC0000622-230166548011-UPITRANSACTIONFOR6,0000230166548011,28/10/22,1178.82,,142535.9, bharti airtel limite,0,"[list([('aayushi super', 10.865290481053918), ('super shoppy', 10.865173862517079), ('aayushi super shoppy', 10.864427223847468), ('pos xxxxxx', 2.4550385779352015), ('ikea india', 1.609971068597172)])]"
248,28/10/22,UPI-WWW AIRTEL IN-AIRTELAUTOPAY.PAYU@HDFCBANK-HDFC0000499-230163850951-UPI MANDATE,0000230163850951,28/10/22,2.0,,142533.9, www airtel in,6,"[list([('chemist paytmqr', 3.9972774836044023), ('tirupati chemist', 3.9967234821483877), ('tirupati chemist paytmqr', 3.9965107262676147), ('akash bhatt', 2.709151344546336), ('makemytrip makemytrip', 2.077909670466702)])]"
250,29/10/22,UPI-JAR  SAVE DAILY-JARMYJARONLINE@YBL-YESB0YBLUPI-230290224868-SUBSCRIPTION DEBIT,0000230290224868,29/10/22,34.0,,142501.9, jar save daily,1,"[list([('jar save daily', 98.03861898739333), ('jar save', 98.03682857485501), ('save daily', 98.03586853418446), ('delight paytm', 3.920523474443698), ('country delight', 3.9147386407433222)])]"
251,30/10/22,UPI-JAR  SAVE DAILY-JARMYJARONLINE@YBL-YESB0YBLUPI-230337531952-SUBSCRIPTION DEBIT,0000230337531952,30/10/22,29.0,,142472.9, jar save daily,1,"[list([('jar save daily', 98.03861898739333), ('jar save', 98.03682857485501), ('save daily', 98.03586853418446), ('delight paytm', 3.920523474443698), ('country delight', 3.9147386407433222)])]"
252,30/10/22,UPI-KOPAL CHOUHAN-CHAUHAN.KOPAL@OKHDFCBANK-HDFC0000036-230309627270-UPI,0000230309627270,30/10/22,38000.0,,104472.9, kopal chouhan chauhan,2,"[list([('gupta juice', 19.243605119465393), ('gupta juice center', 19.24314059509313), ('juice center', 19.241968449100682), ('krishna vegetables', 4.4101114348673125), ('cred club', 3.506991506858471)])]"
253,31/10/22,UPI-JAR  SAVE DAILY-JARMYJARONLINE@YBL-YESB0YBLUPI-230450173106-SUBSCRIPTION DEBIT,0000230450173106,31/10/22,20.0,,104452.9, jar save daily,1,"[list([('jar save daily', 98.03861898739333), ('jar save', 98.03682857485501), ('save daily', 98.03586853418446), ('delight paytm', 3.920523474443698), ('country delight', 3.9147386407433222)])]"
255,31/10/22,UPI-RAJ TVS-GPAY-11194294609@OKBIZAXIS-UTIB0000000-230433619587-UPI,0000230433619587,31/10/22,20000.0,,84453.9, raj tvs gpay,0,"[list([('aayushi super', 10.865290481053918), ('super shoppy', 10.865173862517079), ('aayushi super shoppy', 10.864427223847468), ('pos xxxxxx', 2.4550385779352015), ('ikea india', 1.609971068597172)])]"
256,31/10/22,UPI-NARESH PUROHIT-NP1784534@OKHDFCBANK-HDFC0003522-230434270700-UPI,0000230434270700,31/10/22,30.0,,84423.9, naresh purohit np,4,"[list([('naresh purohit', 11.170927092504018), ('purohit np', 11.167440746173527), ('naresh purohit np', 11.166542020373829), ('gagan pan', 0.13119500953407723), ('pan shop', 0.1307016139459496)])]"
258,31/10/22,UPI-DUNZO DIGITAL PRIVAT-DUNZO.PAYU@HDFCBANK-HDFC0000499-230441500840-DUNZO ORDER,0000230441500840,31/10/22,304.0,,85523.29, dunzo digital privat,3,"[list([('hungerbox paytm', 13.174251604078895), ('aeml awsp', 3.595276358492651), ('ccavenues ccavenues', 2.5585233143451727), ('premji paytmqr', 1.5287022749836985), ('patel premji paytmqr', 1.5276871161621721)])]"
259,01/11/22,UPI-JAR  SAVE DAILY-JARMYJARONLINE@YBL-YESB0YBLUPI-230543815548-SUBSCRIPTION DEBIT,0000230543815548,01/11/22,40.0,,85483.29, jar save daily,1,"[list([('jar save daily', 98.03861898739333), ('jar save', 98.03682857485501), ('save daily', 98.03586853418446), ('delight paytm', 3.920523474443698), ('country delight', 3.9147386407433222)])]"
260,01/11/22,UPI-MOHAMMED ARIF MOHAMM-ARIFSHAIKHZX@OKSBI-IPOS0000001-230560635018-UPI,0000230560635018,01/11/22,164.0,,85319.29, mohammed arif mohamm,0,"[list([('aayushi super', 10.865290481053918), ('super shoppy', 10.865173862517079), ('aayushi super shoppy', 10.864427223847468), ('pos xxxxxx', 2.4550385779352015), ('ikea india', 1.609971068597172)])]"
261,02/11/22,UPI-JAR  SAVE DAILY-JARMYJARONLINE@YBL-YESB0YBLUPI-230648522625-SUBSCRIPTION DEBIT,0000230648522625,02/11/22,40.0,,85279.29, jar save daily,1,"[list([('jar save daily', 98.03861898739333), ('jar save', 98.03682857485501), ('save daily', 98.03586853418446), ('delight paytm', 3.920523474443698), ('country delight', 3.9147386407433222)])]"
262,02/11/22,UPI-HUNGERBOX-PAYTM-8774066@PAYTM-PYTM0123456-230681695394-UPI,0000230681695394,02/11/22,20.0,,85259.29, hungerbox paytm ,3,"[list([('hungerbox paytm', 13.174251604078895), ('aeml awsp', 3.595276358492651), ('ccavenues ccavenues', 2.5585233143451727), ('premji paytmqr', 1.5287022749836985), ('patel premji paytmqr', 1.5276871161621721)])]"
263,02/11/22,UPI-GANESH RAMPYARE YADA-Q26669345@YBL-BARB0PURABG-230683048092-UPI,0000230683048092,02/11/22,143.0,,85116.29, ganesh rampyare yada,0,"[list([('aayushi super', 10.865290481053918), ('super shoppy', 10.865173862517079), ('aayushi super shoppy', 10.864427223847468), ('pos xxxxxx', 2.4550385779352015), ('ikea india', 1.609971068597172)])]"
264,02/11/22,UPI-NARESH PUROHIT-NP1784534@OKHDFCBANK-HDFC0003522-230689389957-UPI,0000230689389957,02/11/22,228.0,,84888.29, naresh purohit np,4,"[list([('naresh purohit', 11.170927092504018), ('purohit np', 11.167440746173527), ('naresh purohit np', 11.166542020373829), ('gagan pan', 0.13119500953407723), ('pan shop', 0.1307016139459496)])]"
265,02/11/22,UPI-MEET MEDICAL AND GEN-PAYTMQR2810050501011C6OWCHM2NCH@PAYTM-PYTM0123456-230691965419-UPI,0000230691965419,02/11/22,98.0,,84790.29, meet medical and,9,"[list([('si tad', 2.035923755867459), ('autopay si tad', 2.0352256901407024), ('autopay si', 2.0348731549436505), ('dc autopay si', 2.032376855832404), ('dc autopay', 2.0312507869052774)])]"
266,02/11/22,UPI-VIMAL SINGH NARENDRA-7738408171@YBL-BCBM0000041-230692052737-UPI,0000230692052737,02/11/22,20.0,,84770.29, vimal singh narendra,0,"[list([('aayushi super', 10.865290481053918), ('super shoppy', 10.865173862517079), ('aayushi super shoppy', 10.864427223847468), ('pos xxxxxx', 2.4550385779352015), ('ikea india', 1.609971068597172)])]"
267,03/11/22,UPI-JAR  SAVE DAILY-JARMYJARONLINE@YBL-YESB0YBLUPI-230716039355-SUBSCRIPTION DEBIT,0000230716039355,03/11/22,36.0,,84734.29, jar save daily,1,"[list([('jar save daily', 98.03861898739333), ('jar save', 98.03682857485501), ('save daily', 98.03586853418446), ('delight paytm', 3.920523474443698), ('country delight', 3.9147386407433222)])]"
268,03/11/22,UPI-RAMNARESH  YADAV-NARESHYADAV80102@OKSBI-UBIN0531774-230712780909-UPI,0000230712780909,03/11/22,60.0,,84674.29, ramnaresh yadav nareshyadav,0,"[list([('aayushi super', 10.865290481053918), ('super shoppy', 10.865173862517079), ('aayushi super shoppy', 10.864427223847468), ('pos xxxxxx', 2.4550385779352015), ('ikea india', 1.609971068597172)])]"
269,03/11/22,UPI-PREMJIRAMJIPATEL-Q660029035@YBL-YESB0YBLUPI-230713102514-UPI,0000230713102514,03/11/22,109.0,,84565.29, premjiramjipatel q ,0,"[list([('aayushi super', 10.865290481053918), ('super shoppy', 10.865173862517079), ('aayushi super shoppy', 10.864427223847468), ('pos xxxxxx', 2.4550385779352015), ('ikea india', 1.609971068597172)])]"
270,03/11/22,UPI-SMITHA VEGETABLES-PAYTMQR281005050101NX5CTEI3M2RR@PAYTM-PYTM0123456-230713181806-UPI,0000230713181806,03/11/22,40.0,,84525.29, smitha vegetables paytmqr,0,"[list([('aayushi super', 10.865290481053918), ('super shoppy', 10.865173862517079), ('aayushi super shoppy', 10.864427223847468), ('pos xxxxxx', 2.4550385779352015), ('ikea india', 1.609971068597172)])]"
271,04/11/22,UPI-JAR  SAVE DAILY-JARMYJARONLINE@YBL-YESB0YBLUPI-230882449492-SUBSCRIPTION DEBIT,0000230882449492,04/11/22,40.0,,84485.29, jar save daily,1,"[list([('jar save daily', 98.03861898739333), ('jar save', 98.03682857485501), ('save daily', 98.03586853418446), ('delight paytm', 3.920523474443698), ('country delight', 3.9147386407433222)])]"
272,05/11/22,DC 1019060021591624 AUTOPAY SI-TAD,0000000465920464,05/11/22,1788.89,,82696.4,dc autopay si tad,9,"[list([('si tad', 2.035923755867459), ('autopay si tad', 2.0352256901407024), ('autopay si', 2.0348731549436505), ('dc autopay si', 2.032376855832404), ('dc autopay', 2.0312507869052774)])]"
273,05/11/22,UPI-JAR  SAVE DAILY-JARMYJARONLINE@YBL-YESB0YBLUPI-230991399130-SUBSCRIPTION DEBIT,0000230991399130,05/11/22,40.0,,82656.4, jar save daily,1,"[list([('jar save daily', 98.03861898739333), ('jar save', 98.03682857485501), ('save daily', 98.03586853418446), ('delight paytm', 3.920523474443698), ('country delight', 3.9147386407433222)])]"
274,06/11/22,UPI-JAR  SAVE DAILY-JARMYJARONLINE@YBL-YESB0YBLUPI-231073140068-SUBSCRIPTION DEBIT,0000231073140068,06/11/22,31.0,,82625.4, jar save daily,1,"[list([('jar save daily', 98.03861898739333), ('jar save', 98.03682857485501), ('save daily', 98.03586853418446), ('delight paytm', 3.920523474443698), ('country delight', 3.9147386407433222)])]"
275,06/11/22,UPI-MS KAMAL OIL DEPOT-Q89708061@YBL-YESB0YBLUPI-231087864366-UPI,0000231087864366,06/11/22,30.0,,82595.4, ms kamal oil,0,"[list([('aayushi super', 10.865290481053918), ('super shoppy', 10.865173862517079), ('aayushi super shoppy', 10.864427223847468), ('pos xxxxxx', 2.4550385779352015), ('ikea india', 1.609971068597172)])]"
276,06/11/22,UPI-RAJ STORES-PAYTMQR281005050101TKAECHVEZYFZ@PAYTM-PYTM0123456-231087862557-UPI,0000231087862557,06/11/22,60.0,,82535.4, raj stores paytmqr,7,"[list([('raj vegetables gpay', 4.360523938382696), ('vegetables gpay', 4.3601697153875785), ('raj vegetables', 4.359825827176104), ('stores paytmqr', 3.567746696089187), ('hair glow', 2.506362310298007)])]"
277,06/11/22,UPI-INDOOMATI WOSHAILESH-BHARATPE90724740780@YESBANKLTD-YESB0YESUPI-231092214014-PAY TO BHARATPE ME,0000231092214014,06/11/22,60.0,,82475.4, indoomati woshailesh bharatpe,0,"[list([('aayushi super', 10.865290481053918), ('super shoppy', 10.865173862517079), ('aayushi super shoppy', 10.864427223847468), ('pos xxxxxx', 2.4550385779352015), ('ikea india', 1.609971068597172)])]"
278,06/11/22,UPI-GUPTA JUICE CENTER-PAYTMQR2810050501011BGLMHIXAJMA@PAYTM-PYTM0123456-231092474287-UPI,0000231092474287,06/11/22,50.0,,82425.4, gupta juice center,2,"[list([('gupta juice', 19.243605119465393), ('gupta juice center', 19.24314059509313), ('juice center', 19.241968449100682), ('krishna vegetables', 4.4101114348673125), ('cred club', 3.506991506858471)])]"
279,06/11/22,UPI-KRISHNA VEGETABLES A-PAYTMQR281005050101OGH9MJCCHZHN@PAYTM-PYTM0123456-231092932703-UPI,0000231092932703,06/11/22,30.0,,82395.4, krishna vegetables a,2,"[list([('gupta juice', 19.243605119465393), ('gupta juice center', 19.24314059509313), ('juice center', 19.241968449100682), ('krishna vegetables', 4.4101114348673125), ('cred club', 3.506991506858471)])]"
280,07/11/22,UPI-JAR  SAVE DAILY-JARMYJARONLINE@YBL-YESB0YBLUPI-231162626646-SUBSCRIPTION DEBIT,0000231162626646,07/11/22,20.0,,82375.4, jar save daily,1,"[list([('jar save daily', 98.03861898739333), ('jar save', 98.03682857485501), ('save daily', 98.03586853418446), ('delight paytm', 3.920523474443698), ('country delight', 3.9147386407433222)])]"
281,07/11/22,UPI-MD AMBAR HUSAIN-PAYTMQR2810050501011CGSBICCMRMB@PAYTM-PYTM0123456-231112308261-UPI,0000231112308261,07/11/22,110.0,,82265.4, md ambar husain,0,"[list([('aayushi super', 10.865290481053918), ('super shoppy', 10.865173862517079), ('aayushi super shoppy', 10.864427223847468), ('pos xxxxxx', 2.4550385779352015), ('ikea india', 1.609971068597172)])]"
282,07/11/22,UPI-AEML-AWSP3@IDFCBANK-IDFB0040101-231117159874-UPI,0000231117159874,07/11/22,1520.0,,80745.4, aeml awsp ,3,"[list([('hungerbox paytm', 13.174251604078895), ('aeml awsp', 3.595276358492651), ('ccavenues ccavenues', 2.5585233143451727), ('premji paytmqr', 1.5287022749836985), ('patel premji paytmqr', 1.5276871161621721)])]"
283,08/11/22,UPI-JAR  SAVE DAILY-JARMYJARONLINE@YBL-YESB0YBLUPI-231222911766-SUBSCRIPTION DEBIT,0000231222911766,08/11/22,40.0,,80705.4, jar save daily,1,"[list([('jar save daily', 98.03861898739333), ('jar save', 98.03682857485501), ('save daily', 98.03586853418446), ('delight paytm', 3.920523474443698), ('country delight', 3.9147386407433222)])]"
284,08/11/22,UPI-OLAFINANCIALSERVICES-OLAFINANCIALSERVICESPRIVATELIMITED.RZP@SBI-SBIN0016209-231221862189-UPI,0000231221862189,08/11/22,1988.0,,78717.4, olafinancialservices olafinancialservicesprivatelimited rzp,0,"[list([('aayushi super', 10.865290481053918), ('super shoppy', 10.865173862517079), ('aayushi super shoppy', 10.864427223847468), ('pos xxxxxx', 2.4550385779352015), ('ikea india', 1.609971068597172)])]"
285,08/11/22,UPI-IRCTC APP UPI-PAYTM-IRCTCAPP@PAYTM-PYTM0123456-231211971529-OID100003771579471,0000231211971529,08/11/22,2828.95,,75888.45, irctc app paytm,7,"[list([('raj vegetables gpay', 4.360523938382696), ('vegetables gpay', 4.3601697153875785), ('raj vegetables', 4.359825827176104), ('stores paytmqr', 3.567746696089187), ('hair glow', 2.506362310298007)])]"
286,08/11/22,UPI-THEOBROMA MARKET CIT-PAYTMQR281005050101J6N7379MM6CT@PAYTM-PYTM0123456-231242704968-UPI,0000231242704968,08/11/22,183.0,,75705.45, theobroma market cit,0,"[list([('aayushi super', 10.865290481053918), ('super shoppy', 10.865173862517079), ('aayushi super shoppy', 10.864427223847468), ('pos xxxxxx', 2.4550385779352015), ('ikea india', 1.609971068597172)])]"
287,08/11/22,UPI-SWATI JAGTAP-PAYTMQR281005050101RLWQVEC142JB@PAYTM-PYTM0123456-231244024938-UPI,0000231244024938,08/11/22,165.0,,75540.45, swati jagtap paytmqr,0,"[list([('aayushi super', 10.865290481053918), ('super shoppy', 10.865173862517079), ('aayushi super shoppy', 10.864427223847468), ('pos xxxxxx', 2.4550385779352015), ('ikea india', 1.609971068597172)])]"
288,08/11/22,UPI-GUPTA JUICE CENTER-PAYTMQR2810050501011BGLMHIXAJMA@PAYTM-PYTM0123456-231244337766-UPI,0000231244337766,08/11/22,50.0,,75490.45, gupta juice center,2,"[list([('gupta juice', 19.243605119465393), ('gupta juice center', 19.24314059509313), ('juice center', 19.241968449100682), ('krishna vegetables', 4.4101114348673125), ('cred club', 3.506991506858471)])]"
289,09/11/22,UPI-JAR  SAVE DAILY-JARMYJARONLINE@YBL-YESB0YBLUPI-231300148753-SUBSCRIPTION DEBIT,0000231300148753,09/11/22,40.0,,75450.45, jar save daily,1,"[list([('jar save daily', 98.03861898739333), ('jar save', 98.03682857485501), ('save daily', 98.03586853418446), ('delight paytm', 3.920523474443698), ('country delight', 3.9147386407433222)])]"
290,09/11/22,UPI-IRCTC APP UPI-PAYTM-IRCTCAPP@PAYTM-PYTM0123456-231317339749-OID100003773382649,0000231317339749,09/11/22,2828.95,,72621.5, irctc app paytm,7,"[list([('raj vegetables gpay', 4.360523938382696), ('vegetables gpay', 4.3601697153875785), ('raj vegetables', 4.359825827176104), ('stores paytmqr', 3.567746696089187), ('hair glow', 2.506362310298007)])]"
291,09/11/22,UPI-COUNTRY DELIGHT-PAYTM-31857153@PAYTM-PYTM0123456-231318295244-SUBSCRIPTION FOR C,0000231318295244,09/11/22,1500.0,,71121.5, country delight paytm,1,"[list([('jar save daily', 98.03861898739333), ('jar save', 98.03682857485501), ('save daily', 98.03586853418446), ('delight paytm', 3.920523474443698), ('country delight', 3.9147386407433222)])]"
292,09/11/22,UPI-NIRMAL ALOK CHHOTELA-Q956867596@YBL-YESB0YBLUPI-231368944857-UPI,0000231368944857,09/11/22,48.0,,71073.5, nirmal alok chhotela,0,"[list([('aayushi super', 10.865290481053918), ('super shoppy', 10.865173862517079), ('aayushi super shoppy', 10.864427223847468), ('pos xxxxxx', 2.4550385779352015), ('ikea india', 1.609971068597172)])]"
293,09/11/22,UPI-GUPTA JUICE CENTER-PAYTMQR2810050501011DNANBBJQ597@PAYTM-PYTM0123456-231369552848-UPI,0000231369552848,09/11/22,50.0,,71023.5, gupta juice center,2,"[list([('gupta juice', 19.243605119465393), ('gupta juice center', 19.24314059509313), ('juice center', 19.241968449100682), ('krishna vegetables', 4.4101114348673125), ('cred club', 3.506991506858471)])]"
294,09/11/22,UPI-KHIRIR  SHEKH-Q331629145@YBL-YESB0YBLUPI-231369681864-UPI,0000231369681864,09/11/22,60.0,,70963.5, khirir shekh q,0,"[list([('aayushi super', 10.865290481053918), ('super shoppy', 10.865173862517079), ('aayushi super shoppy', 10.864427223847468), ('pos xxxxxx', 2.4550385779352015), ('ikea india', 1.609971068597172)])]"
295,10/11/22,UPI-JAR  SAVE DAILY-JARMYJARONLINE@YBL-YESB0YBLUPI-231453724876-SUBSCRIPTION DEBIT,0000231453724876,10/11/22,40.0,,70923.5, jar save daily,1,"[list([('jar save daily', 98.03861898739333), ('jar save', 98.03682857485501), ('save daily', 98.03586853418446), ('delight paytm', 3.920523474443698), ('country delight', 3.9147386407433222)])]"
296,10/11/22,UPI-PANTECH AI-PANTECHAI6.RZP@ICICI-ICIC0DC0099-231475659455-PANTECHAI,0000231475659455,10/11/22,1179.0,,69744.5, pantech ai pantechai,0,"[list([('aayushi super', 10.865290481053918), ('super shoppy', 10.865173862517079), ('aayushi super shoppy', 10.864427223847468), ('pos xxxxxx', 2.4550385779352015), ('ikea india', 1.609971068597172)])]"
297,10/11/22,UPI-MAKEMYTRIP-MAKEMYTRIP.RZP@AXISBANK-UTIB0001507-231482137098-MAKEMYTRIP,0000231482137098,10/11/22,398.0,,69346.5, makemytrip makemytrip rzp,6,"[list([('chemist paytmqr', 3.9972774836044023), ('tirupati chemist', 3.9967234821483877), ('tirupati chemist paytmqr', 3.9965107262676147), ('akash bhatt', 2.709151344546336), ('makemytrip makemytrip', 2.077909670466702)])]"
298,10/11/22,UPI-NARESH PUROHIT-NP1784534@OKHDFCBANK-HDFC0003522-231485272854-UPI,0000231485272854,10/11/22,35.0,,69311.5, naresh purohit np,4,"[list([('naresh purohit', 11.170927092504018), ('purohit np', 11.167440746173527), ('naresh purohit np', 11.166542020373829), ('gagan pan', 0.13119500953407723), ('pan shop', 0.1307016139459496)])]"
299,10/11/22,UPI-MR MAYUR DILIP GHULE-Q999820022@YBL-YESB0YBLUPI-231494668138-UPI,0000231494668138,10/11/22,135.0,,69176.5, mr mayur dilip,3,"[list([('hungerbox paytm', 13.174251604078895), ('aeml awsp', 3.595276358492651), ('ccavenues ccavenues', 2.5585233143451727), ('premji paytmqr', 1.5287022749836985), ('patel premji paytmqr', 1.5276871161621721)])]"
300,10/11/22,UPI-AAYUSHI SUPER SHOPPY-Q392022159@YBL-YESB0YBLUPI-231495690473-UPI,0000231495690473,10/11/22,2995.0,,66181.5, aayushi super shoppy,0,"[list([('aayushi super', 10.865290481053918), ('super shoppy', 10.865173862517079), ('aayushi super shoppy', 10.864427223847468), ('pos xxxxxx', 2.4550385779352015), ('ikea india', 1.609971068597172)])]"
301,10/11/22,UPI-RAMESH HARDEV GUPTA-Q650561614@YBL-YESB0YBLUPI-231495873378-UPI,0000231495873378,10/11/22,35.0,,66146.5, ramesh hardev gupta,0,"[list([('aayushi super', 10.865290481053918), ('super shoppy', 10.865173862517079), ('aayushi super shoppy', 10.864427223847468), ('pos xxxxxx', 2.4550385779352015), ('ikea india', 1.609971068597172)])]"
302,10/11/22,UPI-GUPTA JUICE CENTER-PAYTMQR2810050501011DNANBBJQ597@PAYTM-PYTM0123456-231496259468-UPI,0000231496259468,10/11/22,50.0,,66096.5, gupta juice center,2,"[list([('gupta juice', 19.243605119465393), ('gupta juice center', 19.24314059509313), ('juice center', 19.241968449100682), ('krishna vegetables', 4.4101114348673125), ('cred club', 3.506991506858471)])]"
303,11/11/22,UPI-JAR  SAVE DAILY-JARMYJARONLINE@YBL-YESB0YBLUPI-231563790306-SUBSCRIPTION DEBIT,0000231563790306,11/11/22,40.0,,66056.5, jar save daily,1,"[list([('jar save daily', 98.03861898739333), ('jar save', 98.03682857485501), ('save daily', 98.03586853418446), ('delight paytm', 3.920523474443698), ('country delight', 3.9147386407433222)])]"
304,11/11/22,UPI-MR MAYUR DILIP GHULE-Q999820022@YBL-YESB0YBLUPI-231515018561-UPI,0000231515018561,11/11/22,140.0,,65916.5, mr mayur dilip,3,"[list([('hungerbox paytm', 13.174251604078895), ('aeml awsp', 3.595276358492651), ('ccavenues ccavenues', 2.5585233143451727), ('premji paytmqr', 1.5287022749836985), ('patel premji paytmqr', 1.5276871161621721)])]"
305,11/11/22,UPI-GUPTA JUICE CENTER-PAYTMQR2810050501011DNANBBJQ597@PAYTM-PYTM0123456-231515588682-UPI,0000231515588682,11/11/22,50.0,,65866.5, gupta juice center,2,"[list([('gupta juice', 19.243605119465393), ('gupta juice center', 19.24314059509313), ('juice center', 19.241968449100682), ('krishna vegetables', 4.4101114348673125), ('cred club', 3.506991506858471)])]"
306,11/11/22,UPI-MAKEMYTRIP-MAKEMYTRIP.RZP@AXISBANK-UTIB0001507-231517409827-MAKEMYTRIP,0000231517409827,11/11/22,10484.0,,55382.5, makemytrip makemytrip rzp,6,"[list([('chemist paytmqr', 3.9972774836044023), ('tirupati chemist', 3.9967234821483877), ('tirupati chemist paytmqr', 3.9965107262676147), ('akash bhatt', 2.709151344546336), ('makemytrip makemytrip', 2.077909670466702)])]"
307,12/11/22,50400264425075- RD INSTALLMENT-NOV 2022,000000000000000,11/11/22,1400.0,,53982.5, rd installment nov,5,"[list([('rd installment', 5.604710649033009), ('shantidhan stores', 2.7402329765419635), ('stores gpay', 2.7390542080882083), ('shantidhan stores gpay', 2.7366626902016304), ('installment dec', 2.0266108955371855)])]"
308,12/11/22,UPI-JAR  SAVE DAILY-JARMYJARONLINE@YBL-YESB0YBLUPI-231652434724-SUBSCRIPTION DEBIT,0000231652434724,12/11/22,40.0,,53942.5, jar save daily,1,"[list([('jar save daily', 98.03861898739333), ('jar save', 98.03682857485501), ('save daily', 98.03586853418446), ('delight paytm', 3.920523474443698), ('country delight', 3.9147386407433222)])]"
310,13/11/22,UPI-JAR  SAVE DAILY-JARMYJARONLINE@YBL-YESB0YBLUPI-231747626796-SUBSCRIPTION DEBIT,0000231747626796,13/11/22,40.0,,53903.5, jar save daily,1,"[list([('jar save daily', 98.03861898739333), ('jar save', 98.03682857485501), ('save daily', 98.03586853418446), ('delight paytm', 3.920523474443698), ('country delight', 3.9147386407433222)])]"
311,13/11/22,UPI-NARESH PUROHIT-NP1784534@OKHDFCBANK-HDFC0003522-231761275152-UPI,0000231761275152,13/11/22,170.0,,53733.5, naresh purohit np,4,"[list([('naresh purohit', 11.170927092504018), ('purohit np', 11.167440746173527), ('naresh purohit np', 11.166542020373829), ('gagan pan', 0.13119500953407723), ('pan shop', 0.1307016139459496)])]"
312,14/11/22,50400269095673- RD INSTALLMENT-NOV 2022,000000000000000,13/11/22,10000.0,,43733.5, rd installment nov,5,"[list([('rd installment', 5.604710649033009), ('shantidhan stores', 2.7402329765419635), ('stores gpay', 2.7390542080882083), ('shantidhan stores gpay', 2.7366626902016304), ('installment dec', 2.0266108955371855)])]"
313,14/11/22,UPI-JAR  SAVE DAILY-JARMYJARONLINE@YBL-YESB0YBLUPI-231817772208-SUBSCRIPTION DEBIT,0000231817772208,14/11/22,40.0,,43693.5, jar save daily,1,"[list([('jar save daily', 98.03861898739333), ('jar save', 98.03682857485501), ('save daily', 98.03586853418446), ('delight paytm', 3.920523474443698), ('country delight', 3.9147386407433222)])]"
314,14/11/22,UPI-GUPTA JUICE CENTER-PAYTMQR281005050101HU81CCP8WBFM@PAYTM-PYTM0123456-231891180655-UPI,0000231891180655,14/11/22,100.0,,43593.5, gupta juice center,2,"[list([('gupta juice', 19.243605119465393), ('gupta juice center', 19.24314059509313), ('juice center', 19.241968449100682), ('krishna vegetables', 4.4101114348673125), ('cred club', 3.506991506858471)])]"
315,15/11/22,UPI-JAR  SAVE DAILY-JARMYJARONLINE@YBL-YESB0YBLUPI-231957464260-SUBSCRIPTION DEBIT,0000231957464260,15/11/22,40.0,,43553.5, jar save daily,1,"[list([('jar save daily', 98.03861898739333), ('jar save', 98.03682857485501), ('save daily', 98.03586853418446), ('delight paytm', 3.920523474443698), ('country delight', 3.9147386407433222)])]"
316,15/11/22,UPI-GUPTA JUICE CENTER-PAYTMQR281005050101HU81CCP8WBFM@PAYTM-PYTM0123456-231909749752-UPI,0000231909749752,15/11/22,50.0,,43503.5, gupta juice center,2,"[list([('gupta juice', 19.243605119465393), ('gupta juice center', 19.24314059509313), ('juice center', 19.241968449100682), ('krishna vegetables', 4.4101114348673125), ('cred club', 3.506991506858471)])]"
317,15/11/22,UPI-KRISHNA VEGETABLES A-PAYTMQR2810050501014383BEN69L5M@PAYTM-PYTM0123456-231909980925-UPI,0000231909980925,15/11/22,160.0,,43343.5, krishna vegetables a,2,"[list([('gupta juice', 19.243605119465393), ('gupta juice center', 19.24314059509313), ('juice center', 19.241968449100682), ('krishna vegetables', 4.4101114348673125), ('cred club', 3.506991506858471)])]"
318,15/11/22,UPI-PREMJIRAMJIPATEL-Q660029035@YBL-YESB0YBLUPI-231910118900-UPI,0000231910118900,15/11/22,71.0,,43272.5, premjiramjipatel q ,0,"[list([('aayushi super', 10.865290481053918), ('super shoppy', 10.865173862517079), ('aayushi super shoppy', 10.864427223847468), ('pos xxxxxx', 2.4550385779352015), ('ikea india', 1.609971068597172)])]"
319,15/11/22,UPI-CREDCLUB1-CRED.CLUB@AXISB-UTIB0000114-231951766987-PAYMENT ON CRED,0000231951766987,15/11/22,36139.0,,7133.5, credclub cred club,2,"[list([('gupta juice', 19.243605119465393), ('gupta juice center', 19.24314059509313), ('juice center', 19.241968449100682), ('krishna vegetables', 4.4101114348673125), ('cred club', 3.506991506858471)])]"
320,15/11/22,UPI-MEET MEDICAL AND GEN-PAYTMQR2810050501011O8OQKH4CEHK@PAYTM-PYTM0123456-231913153292-UPI,0000231913153292,15/11/22,180.0,,6953.5, meet medical and,9,"[list([('si tad', 2.035923755867459), ('autopay si tad', 2.0352256901407024), ('autopay si', 2.0348731549436505), ('dc autopay si', 2.032376855832404), ('dc autopay', 2.0312507869052774)])]"
321,15/11/22,UPI-MEET MEDICAL AND GEN-PAYTMQR2810050501011O8OQKH4CEHK@PAYTM-PYTM0123456-231913159555-UPI,0000231913159555,15/11/22,8.0,,6945.5, meet medical and,9,"[list([('si tad', 2.035923755867459), ('autopay si tad', 2.0352256901407024), ('autopay si', 2.0348731549436505), ('dc autopay si', 2.032376855832404), ('dc autopay', 2.0312507869052774)])]"
322,16/11/22,UPI-JAR  SAVE DAILY-JARMYJARONLINE@YBL-YESB0YBLUPI-232064390764-SUBSCRIPTION DEBIT,0000232064390764,16/11/22,40.0,,6905.5, jar save daily,1,"[list([('jar save daily', 98.03861898739333), ('jar save', 98.03682857485501), ('save daily', 98.03586853418446), ('delight paytm', 3.920523474443698), ('country delight', 3.9147386407433222)])]"
323,16/11/22,UPI-MAKEMYTRIP-MAKEMYTRIP.UPI@HDFCBANK-HDFC0000499-232026942519-MAKEMYTRIP,0000232026942519,16/11/22,4912.0,,1993.5, makemytrip makemytrip ,6,"[list([('chemist paytmqr', 3.9972774836044023), ('tirupati chemist', 3.9967234821483877), ('tirupati chemist paytmqr', 3.9965107262676147), ('akash bhatt', 2.709151344546336), ('makemytrip makemytrip', 2.077909670466702)])]"
324,16/11/22,UPI-GUPTA JUICE CENTER-PAYTMQR281005050101HU81CCP8WBFM@PAYTM-PYTM0123456-232041062548-UPI,0000232041062548,16/11/22,50.0,,1943.5, gupta juice center,2,"[list([('gupta juice', 19.243605119465393), ('gupta juice center', 19.24314059509313), ('juice center', 19.241968449100682), ('krishna vegetables', 4.4101114348673125), ('cred club', 3.506991506858471)])]"
325,17/11/22,UPI-JAR  SAVE DAILY-JARMYJARONLINE@YBL-YESB0YBLUPI-232114667489-SUBSCRIPTION DEBIT,0000232114667489,17/11/22,40.0,,1903.5, jar save daily,1,"[list([('jar save daily', 98.03861898739333), ('jar save', 98.03682857485501), ('save daily', 98.03586853418446), ('delight paytm', 3.920523474443698), ('country delight', 3.9147386407433222)])]"
326,17/11/22,UPI-UDEMY-BILLDESKPG.UDEMY@HDFCBANK-HDFC0000499-232149601503-PAY,0000232149601503,17/11/22,449.0,,1454.5, udemy billdeskpg udemy,0,"[list([('aayushi super', 10.865290481053918), ('super shoppy', 10.865173862517079), ('aayushi super shoppy', 10.864427223847468), ('pos xxxxxx', 2.4550385779352015), ('ikea india', 1.609971068597172)])]"
327,17/11/22,UPI-LAKSHMI STORES-PAYTMQR281005050101O4J4AEEIS49G@PAYTM-PYTM0123456-232166503202-UPI,0000232166503202,17/11/22,150.0,,1304.5, lakshmi stores paytmqr,7,"[list([('raj vegetables gpay', 4.360523938382696), ('vegetables gpay', 4.3601697153875785), ('raj vegetables', 4.359825827176104), ('stores paytmqr', 3.567746696089187), ('hair glow', 2.506362310298007)])]"
328,17/11/22,UPI-GUPTA JUICE CENTER-PAYTMQR281005050101HU81CCP8WBFM@PAYTM-PYTM0123456-232166564296-UPI,0000232166564296,17/11/22,50.0,,1254.5, gupta juice center,2,"[list([('gupta juice', 19.243605119465393), ('gupta juice center', 19.24314059509313), ('juice center', 19.241968449100682), ('krishna vegetables', 4.4101114348673125), ('cred club', 3.506991506858471)])]"
329,18/11/22,UPI-JAR  SAVE DAILY-JARMYJARONLINE@YBL-YESB0YBLUPI-232271045374-SUBSCRIPTION DEBIT,0000232271045374,18/11/22,38.0,,1216.5, jar save daily,1,"[list([('jar save daily', 98.03861898739333), ('jar save', 98.03682857485501), ('save daily', 98.03586853418446), ('delight paytm', 3.920523474443698), ('country delight', 3.9147386407433222)])]"
330,18/11/22,UPI-DHWANIL KIRIT CHHEDA-DHWANILCHHEDA3@OKICICI-UBIN0558346-232275485319-UPI,0000232275485319,18/11/22,164.0,,1052.5, dhwanil kirit chheda,0,"[list([('aayushi super', 10.865290481053918), ('super shoppy', 10.865173862517079), ('aayushi super shoppy', 10.864427223847468), ('pos xxxxxx', 2.4550385779352015), ('ikea india', 1.609971068597172)])]"
331,18/11/22,UPI-M ESAKKI-Q987232308@YBL-YESB0YBLUPI-232283995224-UPI,0000232283995224,18/11/22,160.0,,892.5, m esakki q,0,"[list([('aayushi super', 10.865290481053918), ('super shoppy', 10.865173862517079), ('aayushi super shoppy', 10.864427223847468), ('pos xxxxxx', 2.4550385779352015), ('ikea india', 1.609971068597172)])]"
332,19/11/22,UPI-JAR  SAVE DAILY-JARMYJARONLINE@YBL-YESB0YBLUPI-232335999412-SUBSCRIPTION DEBIT,0000232335999412,19/11/22,40.0,,852.5, jar save daily,1,"[list([('jar save daily', 98.03861898739333), ('jar save', 98.03682857485501), ('save daily', 98.03586853418446), ('delight paytm', 3.920523474443698), ('country delight', 3.9147386407433222)])]"
333,19/11/22,UPI-GUPTA JUICE CENTER-PAYTMQR281005050101HU81CCP8WBFM@PAYTM-PYTM0123456-232309811685-UPI,0000232309811685,19/11/22,50.0,,802.5, gupta juice center,2,"[list([('gupta juice', 19.243605119465393), ('gupta juice center', 19.24314059509313), ('juice center', 19.241968449100682), ('krishna vegetables', 4.4101114348673125), ('cred club', 3.506991506858471)])]"
335,19/11/22,UPI-LILAVATI CHEMIST AND-PAYTMQR281005050101ODEELGTX1DHN@PAYTM-PYTM0123456-232316688355-UPI,0000232316688355,19/11/22,90.0,,876.5, lilavati chemist and,0,"[list([('aayushi super', 10.865290481053918), ('super shoppy', 10.865173862517079), ('aayushi super shoppy', 10.864427223847468), ('pos xxxxxx', 2.4550385779352015), ('ikea india', 1.609971068597172)])]"
336,20/11/22,UPI-JAR  SAVE DAILY-JARMYJARONLINE@YBL-YESB0YBLUPI-232418934886-SUBSCRIPTION DEBIT,0000232418934886,20/11/22,40.0,,836.5, jar save daily,1,"[list([('jar save daily', 98.03861898739333), ('jar save', 98.03682857485501), ('save daily', 98.03586853418446), ('delight paytm', 3.920523474443698), ('country delight', 3.9147386407433222)])]"
338,20/11/22,POS 512967XXXXXX4210 IKEA INDIA PVT L,0000000000003719,20/11/22,1563.0,,273.5,pos xxxxxx ikea india,0,"[list([('aayushi super', 10.865290481053918), ('super shoppy', 10.865173862517079), ('aayushi super shoppy', 10.864427223847468), ('pos xxxxxx', 2.4550385779352015), ('ikea india', 1.609971068597172)])]"
339,21/11/22,UPI-JAR  SAVE DAILY-JARMYJARONLINE@YBL-YESB0YBLUPI-232591817312-SUBSCRIPTION DEBIT,0000232591817312,21/11/22,39.0,,234.5, jar save daily,1,"[list([('jar save daily', 98.03861898739333), ('jar save', 98.03682857485501), ('save daily', 98.03586853418446), ('delight paytm', 3.920523474443698), ('country delight', 3.9147386407433222)])]"
340,21/11/22,UPI-GUPTA JUICE CENTER-PAYTMQR281005050101HU81CCP8WBFM@PAYTM-PYTM0123456-232561360174-UPI,0000232561360174,21/11/22,50.0,,184.5, gupta juice center,2,"[list([('gupta juice', 19.243605119465393), ('gupta juice center', 19.24314059509313), ('juice center', 19.241968449100682), ('krishna vegetables', 4.4101114348673125), ('cred club', 3.506991506858471)])]"
342,21/11/22,UPI-BB DAILY-EASEBUZZ.BBDAILY1@HDFCBANK-HDFC0001794-232564647473-UPI,0000232564647473,21/11/22,1500.0,,8684.5, bb daily easebuzz,0,"[list([('aayushi super', 10.865290481053918), ('super shoppy', 10.865173862517079), ('aayushi super shoppy', 10.864427223847468), ('pos xxxxxx', 2.4550385779352015), ('ikea india', 1.609971068597172)])]"
343,22/11/22,UPI-JAR  SAVE DAILY-JARMYJARONLINE@YBL-YESB0YBLUPI-232674425666-SUBSCRIPTION DEBIT,0000232674425666,22/11/22,29.0,,8655.5, jar save daily,1,"[list([('jar save daily', 98.03861898739333), ('jar save', 98.03682857485501), ('save daily', 98.03586853418446), ('delight paytm', 3.920523474443698), ('country delight', 3.9147386407433222)])]"
344,22/11/22,UPI-COUNTRY DELIGHT-PAYTM-31857153@PAYTM-PYTM0123456-232652451014-OIDCDJPMAN73795438,0000232652451014,22/11/22,1500.0,,7155.5, country delight paytm,1,"[list([('jar save daily', 98.03861898739333), ('jar save', 98.03682857485501), ('save daily', 98.03586853418446), ('delight paytm', 3.920523474443698), ('country delight', 3.9147386407433222)])]"
345,22/11/22,UPI-AAYUSHI SUPER SHOPPY-Q392022159@YBL-YESB0YBLUPI-232685231762-UPI,0000232685231762,22/11/22,87.0,,7068.5, aayushi super shoppy,0,"[list([('aayushi super', 10.865290481053918), ('super shoppy', 10.865173862517079), ('aayushi super shoppy', 10.864427223847468), ('pos xxxxxx', 2.4550385779352015), ('ikea india', 1.609971068597172)])]"
346,22/11/22,UPI-RAJ VEGETABLES-GPAY-11204598532@OKBIZAXIS-UTIB0000000-232685495586-UPI,0000232685495586,22/11/22,100.0,,6968.5, raj vegetables gpay,7,"[list([('raj vegetables gpay', 4.360523938382696), ('vegetables gpay', 4.3601697153875785), ('raj vegetables', 4.359825827176104), ('stores paytmqr', 3.567746696089187), ('hair glow', 2.506362310298007)])]"
347,22/11/22,UPI-GUPTA JUICE CENTER-PAYTMQR281005050101HU81CCP8WBFM@PAYTM-PYTM0123456-232685933758-UPI,0000232685933758,22/11/22,50.0,,6918.5, gupta juice center,2,"[list([('gupta juice', 19.243605119465393), ('gupta juice center', 19.24314059509313), ('juice center', 19.241968449100682), ('krishna vegetables', 4.4101114348673125), ('cred club', 3.506991506858471)])]"
348,22/11/22,UPI-SATGURU DAIRY FARM-PAYTMQR2810050501011LU0Q1NNABO5@PAYTM-PYTM0123456-232686107630-UPI,0000232686107630,22/11/22,80.0,,6838.5, satguru dairy farm,0,"[list([('aayushi super', 10.865290481053918), ('super shoppy', 10.865173862517079), ('aayushi super shoppy', 10.864427223847468), ('pos xxxxxx', 2.4550385779352015), ('ikea india', 1.609971068597172)])]"
349,23/11/22,UPI-JAR  SAVE DAILY-JARMYJARONLINE@YBL-YESB0YBLUPI-232744161066-SUBSCRIPTION DEBIT,0000232744161066,23/11/22,40.0,,6798.5, jar save daily,1,"[list([('jar save daily', 98.03861898739333), ('jar save', 98.03682857485501), ('save daily', 98.03586853418446), ('delight paytm', 3.920523474443698), ('country delight', 3.9147386407433222)])]"
350,23/11/22,UPI-AEML-AWSP3@IDFCBANK-IDFB0040101-232707249188-UPI,0000232707249188,23/11/22,1520.0,,5278.5, aeml awsp ,3,"[list([('hungerbox paytm', 13.174251604078895), ('aeml awsp', 3.595276358492651), ('ccavenues ccavenues', 2.5585233143451727), ('premji paytmqr', 1.5287022749836985), ('patel premji paytmqr', 1.5276871161621721)])]"
351,23/11/22,UPI-KESAS-PAYTMQR281005050101W91VBR4K9BNP@PAYTM-PYTM0123456-232707814579-UPI,0000232707814579,23/11/22,140.0,,5138.5, kesas paytmqr w,0,"[list([('aayushi super', 10.865290481053918), ('super shoppy', 10.865173862517079), ('aayushi super shoppy', 10.864427223847468), ('pos xxxxxx', 2.4550385779352015), ('ikea india', 1.609971068597172)])]"
352,24/11/22,UPI-JAR  SAVE DAILY-JARMYJARONLINE@YBL-YESB0YBLUPI-232833723015-SUBSCRIPTION DEBIT,0000232833723015,24/11/22,40.0,,5098.5, jar save daily,1,"[list([('jar save daily', 98.03861898739333), ('jar save', 98.03682857485501), ('save daily', 98.03586853418446), ('delight paytm', 3.920523474443698), ('country delight', 3.9147386407433222)])]"
353,25/11/22,UPI-JAR  SAVE DAILY-JARMYJARONLINE@YBL-YESB0YBLUPI-232982406817-SUBSCRIPTION DEBIT,0000232982406817,25/11/22,40.0,,5058.5, jar save daily,1,"[list([('jar save daily', 98.03861898739333), ('jar save', 98.03682857485501), ('save daily', 98.03586853418446), ('delight paytm', 3.920523474443698), ('country delight', 3.9147386407433222)])]"
354,25/11/22,UPI-GUPTA JUICE CENTER-PAYTMQR281005050101HU81CCP8WBFM@PAYTM-PYTM0123456-232952146110-UPI,0000232952146110,25/11/22,50.0,,5008.5, gupta juice center,2,"[list([('gupta juice', 19.243605119465393), ('gupta juice center', 19.24314059509313), ('juice center', 19.241968449100682), ('krishna vegetables', 4.4101114348673125), ('cred club', 3.506991506858471)])]"
355,26/11/22,UPI-JAR  SAVE DAILY-JARMYJARONLINE@YBL-YESB0YBLUPI-233037871222-SUBSCRIPTION DEBIT,0000233037871222,26/11/22,40.0,,4968.5, jar save daily,1,"[list([('jar save daily', 98.03861898739333), ('jar save', 98.03682857485501), ('save daily', 98.03586853418446), ('delight paytm', 3.920523474443698), ('country delight', 3.9147386407433222)])]"
356,26/11/22,UPI-AAYUSHI SUPER SHOPPY-Q392022159@YBL-YESB0YBLUPI-233074990416-UPI,0000233074990416,26/11/22,1645.0,,3323.5, aayushi super shoppy,0,"[list([('aayushi super', 10.865290481053918), ('super shoppy', 10.865173862517079), ('aayushi super shoppy', 10.864427223847468), ('pos xxxxxx', 2.4550385779352015), ('ikea india', 1.609971068597172)])]"
357,26/11/22,UPI-GUPTA JUICE CENTER-PAYTMQR281005050101HU81CCP8WBFM@PAYTM-PYTM0123456-233075443826-UPI,0000233075443826,26/11/22,80.0,,3243.5, gupta juice center,2,"[list([('gupta juice', 19.243605119465393), ('gupta juice center', 19.24314059509313), ('juice center', 19.241968449100682), ('krishna vegetables', 4.4101114348673125), ('cred club', 3.506991506858471)])]"
358,26/11/22,UPI-KANI DEPARTMENTAL ST-KANIDEPARTMENTALSTOR.41503684@HDFCBANK-HDFC0000001-233075577750-UPI,0000233075577750,26/11/22,246.0,,2997.5, kani departmental st,6,"[list([('chemist paytmqr', 3.9972774836044023), ('tirupati chemist', 3.9967234821483877), ('tirupati chemist paytmqr', 3.9965107262676147), ('akash bhatt', 2.709151344546336), ('makemytrip makemytrip', 2.077909670466702)])]"
359,26/11/22,UPI-TIRUPATI CHEMIST-PAYTMQR281005050101K07O2S9FR1JW@PAYTM-PYTM0123456-233075733056-UPI,0000233075733056,26/11/22,300.0,,2697.5, tirupati chemist paytmqr,6,"[list([('chemist paytmqr', 3.9972774836044023), ('tirupati chemist', 3.9967234821483877), ('tirupati chemist paytmqr', 3.9965107262676147), ('akash bhatt', 2.709151344546336), ('makemytrip makemytrip', 2.077909670466702)])]"
360,27/11/22,UPI-JAR  SAVE DAILY-JARMYJARONLINE@YBL-YESB0YBLUPI-233126768300-SUBSCRIPTION DEBIT,0000233126768300,27/11/22,40.0,,2657.5, jar save daily,1,"[list([('jar save daily', 98.03861898739333), ('jar save', 98.03682857485501), ('save daily', 98.03586853418446), ('delight paytm', 3.920523474443698), ('country delight', 3.9147386407433222)])]"
362,27/11/22,UPI-GUPTA JUICE CENTER-PAYTMQR281005050101HU81CCP8WBFM@PAYTM-PYTM0123456-233197900583-UPI,0000233197900583,27/11/22,50.0,,2608.5, gupta juice center,2,"[list([('gupta juice', 19.243605119465393), ('gupta juice center', 19.24314059509313), ('juice center', 19.241968449100682), ('krishna vegetables', 4.4101114348673125), ('cred club', 3.506991506858471)])]"
363,28/11/22,UPI-JAR  SAVE DAILY-JARMYJARONLINE@YBL-YESB0YBLUPI-233231390987-SUBSCRIPTION DEBIT,0000233231390987,28/11/22,23.0,,2585.5, jar save daily,1,"[list([('jar save daily', 98.03861898739333), ('jar save', 98.03682857485501), ('save daily', 98.03586853418446), ('delight paytm', 3.920523474443698), ('country delight', 3.9147386407433222)])]"
364,28/11/22,UPI-RAZORPAY SOFTWARE PV-RPY.QRREDCLIFFEL97099742@ICICI-ICIC0DC0099-233204529254-PAYMENTTOREDCLIFFE,0000233204529254,28/11/22,699.0,,1886.5, razorpay software pv,2,"[list([('gupta juice', 19.243605119465393), ('gupta juice center', 19.24314059509313), ('juice center', 19.241968449100682), ('krishna vegetables', 4.4101114348673125), ('cred club', 3.506991506858471)])]"
365,28/11/22,UPI-SHIRSAT PARIJAT SHR-Q13109565@YBL-YESB0YBLUPI-233216648730-UPI,0000233216648730,28/11/22,70.0,,1816.5, shirsat parijat shr,0,"[list([('aayushi super', 10.865290481053918), ('super shoppy', 10.865173862517079), ('aayushi super shoppy', 10.864427223847468), ('pos xxxxxx', 2.4550385779352015), ('ikea india', 1.609971068597172)])]"
366,28/11/22,UPI-GUPTA JUICE CENTER-PAYTMQR281005050101HU81CCP8WBFM@PAYTM-PYTM0123456-233216894954-UPI,0000233216894954,28/11/22,50.0,,1766.5, gupta juice center,2,"[list([('gupta juice', 19.243605119465393), ('gupta juice center', 19.24314059509313), ('juice center', 19.241968449100682), ('krishna vegetables', 4.4101114348673125), ('cred club', 3.506991506858471)])]"
367,28/11/22,UPI-PATEL PREMJI-PAYTMQR2810050501018R20GNQ0TD01@PAYTM-PYTM0123456-233217721611-UPI,0000233217721611,28/11/22,35.0,,1731.5, patel premji paytmqr,3,"[list([('hungerbox paytm', 13.174251604078895), ('aeml awsp', 3.595276358492651), ('ccavenues ccavenues', 2.5585233143451727), ('premji paytmqr', 1.5287022749836985), ('patel premji paytmqr', 1.5276871161621721)])]"
368,29/11/22,UPI-WWW AIRTEL IN-AIRTELAUTOPAY.PAYU@HDFCBANK-HDFC0000499-233323346345-UPI MANDATE,0000233323346345,29/11/22,1185.9,,545.6, www airtel in,6,"[list([('chemist paytmqr', 3.9972774836044023), ('tirupati chemist', 3.9967234821483877), ('tirupati chemist paytmqr', 3.9965107262676147), ('akash bhatt', 2.709151344546336), ('makemytrip makemytrip', 2.077909670466702)])]"
369,29/11/22,UPI-JAR  SAVE DAILY-JARMYJARONLINE@YBL-YESB0YBLUPI-233390110658-SUBSCRIPTION DEBIT,0000233390110658,29/11/22,20.0,,525.6, jar save daily,1,"[list([('jar save daily', 98.03861898739333), ('jar save', 98.03682857485501), ('save daily', 98.03586853418446), ('delight paytm', 3.920523474443698), ('country delight', 3.9147386407433222)])]"
371,29/11/22,UPI-SUMIT MOHAN GUPTA-SUMITMG@OKICICI-BARB0PANKIX-233325524571-EDUCATION LOAN,0000233325524571,29/11/22,24000.0,,108472.6, sumit mohan gupta,8,"[list([('sumit mohan', 4.505268486902978), ('mohan gupta', 4.504494554311667), ('sumit mohan gupta', 4.502622451115006), ('jiofiber jiofiber', 2.613046376779851), ('olamoney razorpay', 1.7976716994787716)])]"
372,29/11/22,UPI-KOPAL CHOUHAN-CHAUHAN.KOPAL@OKHDFCBANK-HDFC0000036-233325606660-UPI,0000233325606660,29/11/22,39000.0,,69472.6, kopal chouhan chauhan,2,"[list([('gupta juice', 19.243605119465393), ('gupta juice center', 19.24314059509313), ('juice center', 19.241968449100682), ('krishna vegetables', 4.4101114348673125), ('cred club', 3.506991506858471)])]"
373,29/11/22,UPI-B G DISTRIBUTORS PVT-BGDISTRIBUTORSPVTLTD.RZP@ICICI-ICIC0DC0099-233325771350-PGSHOPPOWEREDBYBGD,0000233325771350,29/11/22,399.0,,69073.6, b g distributors,0,"[list([('aayushi super', 10.865290481053918), ('super shoppy', 10.865173862517079), ('aayushi super shoppy', 10.864427223847468), ('pos xxxxxx', 2.4550385779352015), ('ikea india', 1.609971068597172)])]"
374,29/11/22,UPI-CREDCLUB1-CRED.CLUB@AXISB-UTIB0000114-233329410223-PAYMENT ON CRED,0000233329410223,29/11/22,1185.9,,67887.7, credclub cred club,2,"[list([('gupta juice', 19.243605119465393), ('gupta juice center', 19.24314059509313), ('juice center', 19.241968449100682), ('krishna vegetables', 4.4101114348673125), ('cred club', 3.506991506858471)])]"
376,30/11/22,UPI-JAR  SAVE DAILY-JARMYJARONLINE@YBL-YESB0YBLUPI-233451600877-SUBSCRIPTION DEBIT,0000233451600877,30/11/22,40.0,,67848.7, jar save daily,1,"[list([('jar save daily', 98.03861898739333), ('jar save', 98.03682857485501), ('save daily', 98.03586853418446), ('delight paytm', 3.920523474443698), ('country delight', 3.9147386407433222)])]"
378,30/11/22,UPI-GUPTA JUICE CENTER-PAYTMQR281005050101HU81CCP8WBFM@PAYTM-PYTM0123456-233464525943-UPI,0000233464525943,30/11/22,50.0,,69202.09, gupta juice center,2,"[list([('gupta juice', 19.243605119465393), ('gupta juice center', 19.24314059509313), ('juice center', 19.241968449100682), ('krishna vegetables', 4.4101114348673125), ('cred club', 3.506991506858471)])]"
379,30/11/22,UPI-RAJ VEGETABLES-GPAY-11204598532@OKBIZAXIS-UTIB0000000-233464995342-UPI,0000233464995342,30/11/22,130.0,,69072.09, raj vegetables gpay,7,"[list([('raj vegetables gpay', 4.360523938382696), ('vegetables gpay', 4.3601697153875785), ('raj vegetables', 4.359825827176104), ('stores paytmqr', 3.567746696089187), ('hair glow', 2.506362310298007)])]"
380,01/12/22,UPI-JAR  SAVE DAILY-JARMYJARONLINE@YBL-YESB0YBLUPI-233501621639-SUBSCRIPTION DEBIT,0000233501621639,01/12/22,40.0,,69032.09, jar save daily,1,"[list([('jar save daily', 98.03861898739333), ('jar save', 98.03682857485501), ('save daily', 98.03586853418446), ('delight paytm', 3.920523474443698), ('country delight', 3.9147386407433222)])]"
381,01/12/22,UPI-OLA POSTPAID-OLAMONEY1.PAYU@HDFCBANK-HDFC0000499-233574631658-UPI,0000233574631658,01/12/22,1095.0,,67937.09, ola postpaid olamoney,0,"[list([('aayushi super', 10.865290481053918), ('super shoppy', 10.865173862517079), ('aayushi super shoppy', 10.864427223847468), ('pos xxxxxx', 2.4550385779352015), ('ikea india', 1.609971068597172)])]"
382,02/12/22,UPI-JAR  SAVE DAILY-JARMYJARONLINE@YBL-YESB0YBLUPI-233694549314-SUBSCRIPTION DEBIT,0000233694549314,02/12/22,40.0,,67897.09, jar save daily,1,"[list([('jar save daily', 98.03861898739333), ('jar save', 98.03682857485501), ('save daily', 98.03586853418446), ('delight paytm', 3.920523474443698), ('country delight', 3.9147386407433222)])]"
383,03/12/22,UPI-JAR  SAVE DAILY-JARMYJARONLINE@YBL-YESB0YBLUPI-233742362728-SUBSCRIPTION DEBIT,0000233742362728,03/12/22,36.0,,67861.09, jar save daily,1,"[list([('jar save daily', 98.03861898739333), ('jar save', 98.03682857485501), ('save daily', 98.03586853418446), ('delight paytm', 3.920523474443698), ('country delight', 3.9147386407433222)])]"
384,03/12/22,UPI-STAR FOODS-PAYTMQR2810050501011E0VYK8DIWIO@PAYTM-PYTM0123456-233740956890-UPI,0000233740956890,03/12/22,330.0,,67531.09, star foods paytmqr,0,"[list([('aayushi super', 10.865290481053918), ('super shoppy', 10.865173862517079), ('aayushi super shoppy', 10.864427223847468), ('pos xxxxxx', 2.4550385779352015), ('ikea india', 1.609971068597172)])]"
385,03/12/22,UPI-TIRUPATI CHEMIST-PAYTMQR281005050101IA5OF9Q315X5@PAYTM-PYTM0123456-233751769950-UPI,0000233751769950,03/12/22,100.0,,67431.09, tirupati chemist paytmqr,6,"[list([('chemist paytmqr', 3.9972774836044023), ('tirupati chemist', 3.9967234821483877), ('tirupati chemist paytmqr', 3.9965107262676147), ('akash bhatt', 2.709151344546336), ('makemytrip makemytrip', 2.077909670466702)])]"
386,03/12/22,UPI-BRIJESH DAIRY-GPAY-11209778159@OKBIZAXIS-UTIB0000000-233751821821-UPI,0000233751821821,03/12/22,45.0,,67386.09, brijesh dairy gpay,0,"[list([('aayushi super', 10.865290481053918), ('super shoppy', 10.865173862517079), ('aayushi super shoppy', 10.864427223847468), ('pos xxxxxx', 2.4550385779352015), ('ikea india', 1.609971068597172)])]"
387,04/12/22,UPI-JAR  SAVE DAILY-JARMYJARONLINE@YBL-YESB0YBLUPI-233856947458-SUBSCRIPTION DEBIT,0000233856947458,04/12/22,20.0,,67366.09, jar save daily,1,"[list([('jar save daily', 98.03861898739333), ('jar save', 98.03682857485501), ('save daily', 98.03586853418446), ('delight paytm', 3.920523474443698), ('country delight', 3.9147386407433222)])]"
388,04/12/22,UPI-M2MFERRIES-M2MFERRIES@YESBANK-YESB0000728-233859215204-UPI,0000233859215204,04/12/22,2400.0,,64966.09, m mferries m,0,"[list([('aayushi super', 10.865290481053918), ('super shoppy', 10.865173862517079), ('aayushi super shoppy', 10.864427223847468), ('pos xxxxxx', 2.4550385779352015), ('ikea india', 1.609971068597172)])]"
389,04/12/22,UPI-GUPTA JUICE CENTER-PAYTMQR281005050101HU81CCP8WBFM@PAYTM-PYTM0123456-233872596979-UPI,0000233872596979,04/12/22,50.0,,64916.09, gupta juice center,2,"[list([('gupta juice', 19.243605119465393), ('gupta juice center', 19.24314059509313), ('juice center', 19.241968449100682), ('krishna vegetables', 4.4101114348673125), ('cred club', 3.506991506858471)])]"
390,04/12/22,UPI-TIRUPATI CHEMIST-PAYTMQR281005050101IA5OF9Q315X5@PAYTM-PYTM0123456-233872969653-UPI,0000233872969653,04/12/22,220.0,,64696.09, tirupati chemist paytmqr,6,"[list([('chemist paytmqr', 3.9972774836044023), ('tirupati chemist', 3.9967234821483877), ('tirupati chemist paytmqr', 3.9965107262676147), ('akash bhatt', 2.709151344546336), ('makemytrip makemytrip', 2.077909670466702)])]"
391,04/12/22,UPI-BABU KHAN-Q198270255@YBL-YESB0YBLUPI-233873109707-UPI,0000233873109707,04/12/22,40.0,,64656.09, babu khan q,0,"[list([('aayushi super', 10.865290481053918), ('super shoppy', 10.865173862517079), ('aayushi super shoppy', 10.864427223847468), ('pos xxxxxx', 2.4550385779352015), ('ikea india', 1.609971068597172)])]"
392,05/12/22,DC 1019060021591624 AUTOPAY SI-TAD,0000000472605670,05/12/22,1788.89,,62867.2,dc autopay si tad,9,"[list([('si tad', 2.035923755867459), ('autopay si tad', 2.0352256901407024), ('autopay si', 2.0348731549436505), ('dc autopay si', 2.032376855832404), ('dc autopay', 2.0312507869052774)])]"
393,05/12/22,UPI-JAR  SAVE DAILY-JARMYJARONLINE@YBL-YESB0YBLUPI-233909444269-SUBSCRIPTION DEBIT,0000233909444269,05/12/22,40.0,,62827.2, jar save daily,1,"[list([('jar save daily', 98.03861898739333), ('jar save', 98.03682857485501), ('save daily', 98.03586853418446), ('delight paytm', 3.920523474443698), ('country delight', 3.9147386407433222)])]"
394,05/12/22,UPI-UBER INDIA SYSTEMS P-UBERRIDES@HDFCBANK-HDFC0000499-233984425364-UBERRIDE,0000233984425364,05/12/22,844.0,,61983.2, uber india systems,9,"[list([('si tad', 2.035923755867459), ('autopay si tad', 2.0352256901407024), ('autopay si', 2.0348731549436505), ('dc autopay si', 2.032376855832404), ('dc autopay', 2.0312507869052774)])]"
395,05/12/22,UPI-UBER INDIA SYSTEMS P-UBERRIDES@HDFCBANK-HDFC0000499-233990505825-UBERRIDE,0000233990505825,05/12/22,375.73,,61607.47, uber india systems,9,"[list([('si tad', 2.035923755867459), ('autopay si tad', 2.0352256901407024), ('autopay si', 2.0348731549436505), ('dc autopay si', 2.032376855832404), ('dc autopay', 2.0312507869052774)])]"
396,05/12/22,UPI-AAYUSHI SUPER SHOPPY-Q392022159@YBL-YESB0YBLUPI-233900784447-UPI,0000233900784447,05/12/22,168.0,,61439.47, aayushi super shoppy,0,"[list([('aayushi super', 10.865290481053918), ('super shoppy', 10.865173862517079), ('aayushi super shoppy', 10.864427223847468), ('pos xxxxxx', 2.4550385779352015), ('ikea india', 1.609971068597172)])]"
397,05/12/22,UPI-GUPTA JUICE CENTER-PAYTMQR281005050101HU81CCP8WBFM@PAYTM-PYTM0123456-233900858055-UPI,0000233900858055,05/12/22,50.0,,61389.47, gupta juice center,2,"[list([('gupta juice', 19.243605119465393), ('gupta juice center', 19.24314059509313), ('juice center', 19.241968449100682), ('krishna vegetables', 4.4101114348673125), ('cred club', 3.506991506858471)])]"
398,06/12/22,UPI-JAR  SAVE DAILY-JARMYJARONLINE@YBL-YESB0YBLUPI-234094356756-SUBSCRIPTION DEBIT,0000234094356756,06/12/22,36.0,,61353.47, jar save daily,1,"[list([('jar save daily', 98.03861898739333), ('jar save', 98.03682857485501), ('save daily', 98.03586853418446), ('delight paytm', 3.920523474443698), ('country delight', 3.9147386407433222)])]"
399,07/12/22,UPI-JAR  SAVE DAILY-JARMYJARONLINE@YBL-YESB0YBLUPI-234147322016-SUBSCRIPTION DEBIT,0000234147322016,07/12/22,34.0,,61319.47, jar save daily,1,"[list([('jar save daily', 98.03861898739333), ('jar save', 98.03682857485501), ('save daily', 98.03586853418446), ('delight paytm', 3.920523474443698), ('country delight', 3.9147386407433222)])]"
400,07/12/22,UPI-VECTOR DIMENSIONS PV-9321651767@OKBIZAXIS-UTIB0000000-234138769770-SUMIT GUPTA 11 DEC,0000234138769770,07/12/22,3200.0,,58119.47, vector dimensions pv,0,"[list([('aayushi super', 10.865290481053918), ('super shoppy', 10.865173862517079), ('aayushi super shoppy', 10.864427223847468), ('pos xxxxxx', 2.4550385779352015), ('ikea india', 1.609971068597172)])]"
401,07/12/22,UPI-KANI DEPARTMENTAL ST-KANIDEPARTMENTALSTOR.41503684@HDFCBANK-HDFC0000001-234151119038-UPI,0000234151119038,07/12/22,215.0,,57904.47, kani departmental st,6,"[list([('chemist paytmqr', 3.9972774836044023), ('tirupati chemist', 3.9967234821483877), ('tirupati chemist paytmqr', 3.9965107262676147), ('akash bhatt', 2.709151344546336), ('makemytrip makemytrip', 2.077909670466702)])]"
402,07/12/22,UPI-GUPTA JUICE CENTER-PAYTMQR281005050101HU81CCP8WBFM@PAYTM-PYTM0123456-234151250169-UPI,0000234151250169,07/12/22,50.0,,57854.47, gupta juice center,2,"[list([('gupta juice', 19.243605119465393), ('gupta juice center', 19.24314059509313), ('juice center', 19.241968449100682), ('krishna vegetables', 4.4101114348673125), ('cred club', 3.506991506858471)])]"
403,07/12/22,UPI-AAYUSHI SUPER SHOPPY-Q392022159@YBL-YESB0YBLUPI-234151476722-UPI,0000234151476722,07/12/22,210.0,,57644.47, aayushi super shoppy,0,"[list([('aayushi super', 10.865290481053918), ('super shoppy', 10.865173862517079), ('aayushi super shoppy', 10.864427223847468), ('pos xxxxxx', 2.4550385779352015), ('ikea india', 1.609971068597172)])]"
404,07/12/22,UPI-AAYUSHI SUPER SHOPPY-Q392022159@YBL-YESB0YBLUPI-234151526732-UPI,0000234151526732,07/12/22,36.0,,57608.47, aayushi super shoppy,0,"[list([('aayushi super', 10.865290481053918), ('super shoppy', 10.865173862517079), ('aayushi super shoppy', 10.864427223847468), ('pos xxxxxx', 2.4550385779352015), ('ikea india', 1.609971068597172)])]"
405,07/12/22,UPI-KIRAN ENTERPRISES-PAYTMQR281005050101QA3MFU5MKQK5@PAYTM-PYTM0123456-234151707275-UPI,0000234151707275,07/12/22,40.0,,57568.47, kiran enterprises paytmqr,0,"[list([('aayushi super', 10.865290481053918), ('super shoppy', 10.865173862517079), ('aayushi super shoppy', 10.864427223847468), ('pos xxxxxx', 2.4550385779352015), ('ikea india', 1.609971068597172)])]"
406,08/12/22,UPI-JAR  SAVE DAILY-JARMYJARONLINE@YBL-YESB0YBLUPI-234240693589-SUBSCRIPTION DEBIT,0000234240693589,08/12/22,20.0,,57548.47, jar save daily,1,"[list([('jar save daily', 98.03861898739333), ('jar save', 98.03682857485501), ('save daily', 98.03586853418446), ('delight paytm', 3.920523474443698), ('country delight', 3.9147386407433222)])]"
407,08/12/22,IB FUNDS TRANSFER DR-02981530008339  -SUMIT MOHAN GUPTA,IB08140704318779,08/12/22,5000.0,,52548.47,ib funds transfer dr,2,"[list([('gupta juice', 19.243605119465393), ('gupta juice center', 19.24314059509313), ('juice center', 19.241968449100682), ('krishna vegetables', 4.4101114348673125), ('cred club', 3.506991506858471)])]"
408,08/12/22,UPI-TIRUPATI CHEMIST-PAYTMQR281005050101IA5OF9Q315X5@PAYTM-PYTM0123456-234277803424-UPI,0000234277803424,08/12/22,290.0,,52258.47, tirupati chemist paytmqr,6,"[list([('chemist paytmqr', 3.9972774836044023), ('tirupati chemist', 3.9967234821483877), ('tirupati chemist paytmqr', 3.9965107262676147), ('akash bhatt', 2.709151344546336), ('makemytrip makemytrip', 2.077909670466702)])]"
409,08/12/22,UPI-RANAK ENTERPRISES-Q148463082@YBL-YESB0YBLUPI-234277870174-UPI,0000234277870174,08/12/22,70.0,,52188.47, ranak enterprises q,0,"[list([('aayushi super', 10.865290481053918), ('super shoppy', 10.865173862517079), ('aayushi super shoppy', 10.864427223847468), ('pos xxxxxx', 2.4550385779352015), ('ikea india', 1.609971068597172)])]"
410,09/12/22,UPI-JAR  SAVE DAILY-JARMYJARONLINE@YBL-YESB0YBLUPI-234339265035-SUBSCRIPTION DEBIT,0000234339265035,09/12/22,40.0,,52148.47, jar save daily,1,"[list([('jar save daily', 98.03861898739333), ('jar save', 98.03682857485501), ('save daily', 98.03586853418446), ('delight paytm', 3.920523474443698), ('country delight', 3.9147386407433222)])]"
411,09/12/22,UPI-CREDPAYURBANCOMPANY-CREDPAY.UBCP@AXISB-UTIB0000114-234372587863-PAYMENT ON CRED,0000234372587863,09/12/22,2256.0,,49892.47, credpayurbancompany credpay ubcp,0,"[list([('aayushi super', 10.865290481053918), ('super shoppy', 10.865173862517079), ('aayushi super shoppy', 10.864427223847468), ('pos xxxxxx', 2.4550385779352015), ('ikea india', 1.609971068597172)])]"
413,09/12/22,UPI-SUMIT MOHAN GUPTA-SUMITMG@OKICICI-BARB0PANKIX-234388807306-EDUCATION LOAN,0000234388807306,09/12/22,24000.0,,57892.47, sumit mohan gupta,8,"[list([('sumit mohan', 4.505268486902978), ('mohan gupta', 4.504494554311667), ('sumit mohan gupta', 4.502622451115006), ('jiofiber jiofiber', 2.613046376779851), ('olamoney razorpay', 1.7976716994787716)])]"
414,09/12/22,UPI-GUPTA JUICE CENTER-PAYTMQR281005050101HU81CCP8WBFM@PAYTM-PYTM0123456-234395342797-UPI,0000234395342797,09/12/22,50.0,,57842.47, gupta juice center,2,"[list([('gupta juice', 19.243605119465393), ('gupta juice center', 19.24314059509313), ('juice center', 19.241968449100682), ('krishna vegetables', 4.4101114348673125), ('cred club', 3.506991506858471)])]"
415,09/12/22,UPI-RAJ VEGETABLES-GPAY-11204598532@OKBIZAXIS-UTIB0000000-234395631825-UPI,0000234395631825,09/12/22,190.0,,57652.47, raj vegetables gpay,7,"[list([('raj vegetables gpay', 4.360523938382696), ('vegetables gpay', 4.3601697153875785), ('raj vegetables', 4.359825827176104), ('stores paytmqr', 3.567746696089187), ('hair glow', 2.506362310298007)])]"
416,09/12/22,UPI-AAYUSHI SUPER SHOPPY-Q392022159@YBL-YESB0YBLUPI-234395792072-UPI,0000234395792072,09/12/22,413.0,,57239.47, aayushi super shoppy,0,"[list([('aayushi super', 10.865290481053918), ('super shoppy', 10.865173862517079), ('aayushi super shoppy', 10.864427223847468), ('pos xxxxxx', 2.4550385779352015), ('ikea india', 1.609971068597172)])]"
417,09/12/22,UPI-MANISHA SHOE MART-GPAY-11215258929@OKBIZAXIS-UTIB0000000-234396475709-UPI,0000234396475709,09/12/22,40.0,,57199.47, manisha shoe mart,0,"[list([('aayushi super', 10.865290481053918), ('super shoppy', 10.865173862517079), ('aayushi super shoppy', 10.864427223847468), ('pos xxxxxx', 2.4550385779352015), ('ikea india', 1.609971068597172)])]"
418,10/12/22,UPI-JAR  SAVE DAILY-JARMYJARONLINE@YBL-YESB0YBLUPI-234429039364-SUBSCRIPTION DEBIT,0000234429039364,10/12/22,40.0,,57159.47, jar save daily,1,"[list([('jar save daily', 98.03861898739333), ('jar save', 98.03682857485501), ('save daily', 98.03586853418446), ('delight paytm', 3.920523474443698), ('country delight', 3.9147386407433222)])]"
419,10/12/22,UPI-RAJ 2 WHEEELERS LLP-GPAY-11194294614@OKBIZAXIS-UTIB0000000-234412623229-UPI,0000234412623229,10/12/22,933.0,,56226.47, raj wheeelers llp,0,"[list([('aayushi super', 10.865290481053918), ('super shoppy', 10.865173862517079), ('aayushi super shoppy', 10.864427223847468), ('pos xxxxxx', 2.4550385779352015), ('ikea india', 1.609971068597172)])]"
420,10/12/22,UPI-GUPTA JUICE CENTER-PAYTMQR281005050101HU81CCP8WBFM@PAYTM-PYTM0123456-234413434325-UPI,0000234413434325,10/12/22,50.0,,56176.47, gupta juice center,2,"[list([('gupta juice', 19.243605119465393), ('gupta juice center', 19.24314059509313), ('juice center', 19.241968449100682), ('krishna vegetables', 4.4101114348673125), ('cred club', 3.506991506858471)])]"
421,10/12/22,UPI-TIRUPATI CHEMIST-PAYTMQR281005050101K07O2S9FR1JW@PAYTM-PYTM0123456-234430739758-UPI,0000234430739758,10/12/22,300.0,,55876.47, tirupati chemist paytmqr,6,"[list([('chemist paytmqr', 3.9972774836044023), ('tirupati chemist', 3.9967234821483877), ('tirupati chemist paytmqr', 3.9965107262676147), ('akash bhatt', 2.709151344546336), ('makemytrip makemytrip', 2.077909670466702)])]"
422,10/12/22,UPI-RAJ STORES-PAYTMQR2810050501011FPCOYEWW8B2@PAYTM-PYTM0123456-234430812775-UPI,0000234430812775,10/12/22,245.0,,55631.47, raj stores paytmqr,7,"[list([('raj vegetables gpay', 4.360523938382696), ('vegetables gpay', 4.3601697153875785), ('raj vegetables', 4.359825827176104), ('stores paytmqr', 3.567746696089187), ('hair glow', 2.506362310298007)])]"
423,11/12/22,UPI-COUNTRY DELIGHT-PAYTM-31857153@PAYTM-PYTM0123456-234508219148-OIDCDJPMAN73795438,0000234508219148,11/12/22,1500.0,,54131.47, country delight paytm,1,"[list([('jar save daily', 98.03861898739333), ('jar save', 98.03682857485501), ('save daily', 98.03586853418446), ('delight paytm', 3.920523474443698), ('country delight', 3.9147386407433222)])]"
424,11/12/22,UPI-JAR  SAVE DAILY-JARMYJARONLINE@YBL-YESB0YBLUPI-234519636549-SUBSCRIPTION DEBIT,0000234519636549,11/12/22,40.0,,54091.47, jar save daily,1,"[list([('jar save daily', 98.03861898739333), ('jar save', 98.03682857485501), ('save daily', 98.03586853418446), ('delight paytm', 3.920523474443698), ('country delight', 3.9147386407433222)])]"
425,11/12/22,UPI-BLUE COAST BEACH RES-BLUECOASTBEACHRESORT.62223207@HDFCBANK-HDFC0000001-234537268841-UPI,0000234537268841,11/12/22,6342.0,,47749.47, blue coast beach,0,"[list([('aayushi super', 10.865290481053918), ('super shoppy', 10.865173862517079), ('aayushi super shoppy', 10.864427223847468), ('pos xxxxxx', 2.4550385779352015), ('ikea india', 1.609971068597172)])]"
426,11/12/22,UPI-APPLE SERVICES-BILLDESKPG.APPLESERVICES@HDFCBANK-HDFC0000499-234549290574-APPLESERVICES,0000234549290574,11/12/22,2000.0,,45749.47, apple services billdeskpg,0,"[list([('aayushi super', 10.865290481053918), ('super shoppy', 10.865173862517079), ('aayushi super shoppy', 10.864427223847468), ('pos xxxxxx', 2.4550385779352015), ('ikea india', 1.609971068597172)])]"
427,11/12/22,UPI-SHANTIDHAN STORES-GPAY-11193150575@OKBIZAXIS-UTIB0000000-234544549819-UPI,0000234544549819,11/12/22,260.0,,45489.47, shantidhan stores gpay,5,"[list([('rd installment', 5.604710649033009), ('shantidhan stores', 2.7402329765419635), ('stores gpay', 2.7390542080882083), ('shantidhan stores gpay', 2.7366626902016304), ('installment dec', 2.0266108955371855)])]"
428,11/12/22,UPI-SHANTIDHAN STORES-GPAY-11193150575@OKBIZAXIS-UTIB0000000-234544585786-UPI,0000234544585786,11/12/22,20.0,,45469.47, shantidhan stores gpay,5,"[list([('rd installment', 5.604710649033009), ('shantidhan stores', 2.7402329765419635), ('stores gpay', 2.7390542080882083), ('shantidhan stores gpay', 2.7366626902016304), ('installment dec', 2.0266108955371855)])]"
429,11/12/22,UPI-SHANTIDHAN STORES-GPAY-11193150575@OKBIZAXIS-UTIB0000000-234544608205-UPI,0000234544608205,11/12/22,10.0,,45459.47, shantidhan stores gpay,5,"[list([('rd installment', 5.604710649033009), ('shantidhan stores', 2.7402329765419635), ('stores gpay', 2.7390542080882083), ('shantidhan stores gpay', 2.7366626902016304), ('installment dec', 2.0266108955371855)])]"
430,11/12/22,UPI-DAIVYOG HOTEL-DAIVYOGHOTEL.63022515@HDFCBANK-HDFC0000001-234549996997-UPI,0000234549996997,11/12/22,1050.0,,44409.47, daivyog hotel daivyoghotel,0,"[list([('aayushi super', 10.865290481053918), ('super shoppy', 10.865173862517079), ('aayushi super shoppy', 10.864427223847468), ('pos xxxxxx', 2.4550385779352015), ('ikea india', 1.609971068597172)])]"
431,12/12/22,50400264425075- RD INSTALLMENT-DEC 2022,000000000000000,11/12/22,1400.0,,43009.47, rd installment dec,5,"[list([('rd installment', 5.604710649033009), ('shantidhan stores', 2.7402329765419635), ('stores gpay', 2.7390542080882083), ('shantidhan stores gpay', 2.7366626902016304), ('installment dec', 2.0266108955371855)])]"
432,12/12/22,UPI-JAR  SAVE DAILY-JARMYJARONLINE@YBL-YESB0YBLUPI-234622199116-SUBSCRIPTION DEBIT,0000234622199116,12/12/22,40.0,,42969.47, jar save daily,1,"[list([('jar save daily', 98.03861898739333), ('jar save', 98.03682857485501), ('save daily', 98.03586853418446), ('delight paytm', 3.920523474443698), ('country delight', 3.9147386407433222)])]"
433,12/12/22,UPI-SADGURU AUTO SERVICE-PAYTMQR2810050501011CKDEZB7S1Z2@PAYTM-PYTM0123456-234661963659-UPI,0000234661963659,12/12/22,200.0,,42769.47, sadguru auto service,0,"[list([('aayushi super', 10.865290481053918), ('super shoppy', 10.865173862517079), ('aayushi super shoppy', 10.864427223847468), ('pos xxxxxx', 2.4550385779352015), ('ikea india', 1.609971068597172)])]"
434,13/12/22,UPI-JAR  SAVE DAILY-JARMYJARONLINE@YBL-YESB0YBLUPI-234731956888-SUBSCRIPTION DEBIT,0000234731956888,13/12/22,40.0,,42729.47, jar save daily,1,"[list([('jar save daily', 98.03861898739333), ('jar save', 98.03682857485501), ('save daily', 98.03586853418446), ('delight paytm', 3.920523474443698), ('country delight', 3.9147386407433222)])]"
435,13/12/22,UPI-AAYUSHI SUPER SHOPPY-Q392022159@YBL-YESB0YBLUPI-234798939147-UPI,0000234798939147,13/12/22,687.0,,42042.47, aayushi super shoppy,0,"[list([('aayushi super', 10.865290481053918), ('super shoppy', 10.865173862517079), ('aayushi super shoppy', 10.864427223847468), ('pos xxxxxx', 2.4550385779352015), ('ikea india', 1.609971068597172)])]"
436,13/12/22,UPI-RAJ VEGETABLES-GPAY-11204598532@OKBIZAXIS-UTIB0000000-234799272283-UPI,0000234799272283,13/12/22,420.0,,41622.47, raj vegetables gpay,7,"[list([('raj vegetables gpay', 4.360523938382696), ('vegetables gpay', 4.3601697153875785), ('raj vegetables', 4.359825827176104), ('stores paytmqr', 3.567746696089187), ('hair glow', 2.506362310298007)])]"
437,14/12/22,50400269095673- RD INSTALLMENT-DEC 2022,000000000000000,13/12/22,10000.0,,31622.47, rd installment dec,5,"[list([('rd installment', 5.604710649033009), ('shantidhan stores', 2.7402329765419635), ('stores gpay', 2.7390542080882083), ('shantidhan stores gpay', 2.7366626902016304), ('installment dec', 2.0266108955371855)])]"
438,14/12/22,UPI-JAR  SAVE DAILY-JARMYJARONLINE@YBL-YESB0YBLUPI-234893017552-SUBSCRIPTION DEBIT,0000234893017552,14/12/22,40.0,,31582.47, jar save daily,1,"[list([('jar save daily', 98.03861898739333), ('jar save', 98.03682857485501), ('save daily', 98.03586853418446), ('delight paytm', 3.920523474443698), ('country delight', 3.9147386407433222)])]"
439,14/12/22,UPI-RAZORPAY SOFTWARE PV-RPY.QRREDCLIFFEL29894241@ICICI-ICIC0DC0099-234808427525-PAYMENTTOREDCLIFFE,0000234808427525,14/12/22,255.0,,31327.47, razorpay software pv,2,"[list([('gupta juice', 19.243605119465393), ('gupta juice center', 19.24314059509313), ('juice center', 19.241968449100682), ('krishna vegetables', 4.4101114348673125), ('cred club', 3.506991506858471)])]"
440,14/12/22,UPI-NARESH PUROHIT-NP1784534@OKICICI-HDFC0003522-234821252220-UPI,0000234821252220,14/12/22,115.0,,31212.47, naresh purohit np,4,"[list([('naresh purohit', 11.170927092504018), ('purohit np', 11.167440746173527), ('naresh purohit np', 11.166542020373829), ('gagan pan', 0.13119500953407723), ('pan shop', 0.1307016139459496)])]"
442,14/12/22,UPI-CREDCLUB1-CRED.CLUB@AXISB-UTIB0000114-234859298663-PAYMENT ON CRED,0000234859298663,14/12/22,77811.0,,3401.47, credclub cred club,2,"[list([('gupta juice', 19.243605119465393), ('gupta juice center', 19.24314059509313), ('juice center', 19.241968449100682), ('krishna vegetables', 4.4101114348673125), ('cred club', 3.506991506858471)])]"
443,14/12/22,UPI-GUPTA JUICE CENTER-PAYTMQR281005050101HU81CCP8WBFM@PAYTM-PYTM0123456-234822747409-UPI,0000234822747409,14/12/22,50.0,,3351.47, gupta juice center,2,"[list([('gupta juice', 19.243605119465393), ('gupta juice center', 19.24314059509313), ('juice center', 19.241968449100682), ('krishna vegetables', 4.4101114348673125), ('cred club', 3.506991506858471)])]"
444,15/12/22,UPI-JAR  SAVE DAILY-JARMYJARONLINE@YBL-YESB0YBLUPI-234930532312-SUBSCRIPTION DEBIT,0000234930532312,15/12/22,40.0,,3311.47, jar save daily,1,"[list([('jar save daily', 98.03861898739333), ('jar save', 98.03682857485501), ('save daily', 98.03586853418446), ('delight paytm', 3.920523474443698), ('country delight', 3.9147386407433222)])]"
445,15/12/22,UPI-GUPTA JUICE CENTER-PAYTMQR281005050101HU81CCP8WBFM@PAYTM-PYTM0123456-234937695302-UPI,0000234937695302,15/12/22,50.0,,3261.47, gupta juice center,2,"[list([('gupta juice', 19.243605119465393), ('gupta juice center', 19.24314059509313), ('juice center', 19.241968449100682), ('krishna vegetables', 4.4101114348673125), ('cred club', 3.506991506858471)])]"
447,16/12/22,UPI-JAR  SAVE DAILY-JARMYJARONLINE@YBL-YESB0YBLUPI-235025249341-SUBSCRIPTION DEBIT,0000235025249341,16/12/22,40.0,,114924.47, jar save daily,1,"[list([('jar save daily', 98.03861898739333), ('jar save', 98.03682857485501), ('save daily', 98.03586853418446), ('delight paytm', 3.920523474443698), ('country delight', 3.9147386407433222)])]"
448,16/12/22,UPI-WELLNESS FOREVER AXI-WELLNESSFOREVERAXISVIKHROLIWEST@YBL-YESB0YBLUPI-235062799682-PAYMENT FOR 500970,0000235062799682,16/12/22,467.1,,114457.37, wellness forever axi,0,"[list([('aayushi super', 10.865290481053918), ('super shoppy', 10.865173862517079), ('aayushi super shoppy', 10.864427223847468), ('pos xxxxxx', 2.4550385779352015), ('ikea india', 1.609971068597172)])]"
449,17/12/22,UPI-AHMAD RAJA-PAYTMQR2810050501011A6THGMDQW5R@PAYTM-PYTM0123456-235165098659-UPI,0000235165098659,17/12/22,35.0,,114422.37, ahmad raja paytmqr,0,"[list([('aayushi super', 10.865290481053918), ('super shoppy', 10.865173862517079), ('aayushi super shoppy', 10.864427223847468), ('pos xxxxxx', 2.4550385779352015), ('ikea india', 1.609971068597172)])]"
450,17/12/22,UPI-DATTA SAI KRUPA VEGE-GPAY-11208128958@OKBIZAXIS-UTIB0000000-235165404114-UPI,0000235165404114,17/12/22,15.0,,114407.37, datta sai krupa,0,"[list([('aayushi super', 10.865290481053918), ('super shoppy', 10.865173862517079), ('aayushi super shoppy', 10.864427223847468), ('pos xxxxxx', 2.4550385779352015), ('ikea india', 1.609971068597172)])]"
451,17/12/22,UPI-JAR  SAVE DAILY-JARMYJARONLINE@YBL-YESB0YBLUPI-235128999441-SUBSCRIPTION DEBIT,0000235128999441,17/12/22,40.0,,114367.37, jar save daily,1,"[list([('jar save daily', 98.03861898739333), ('jar save', 98.03682857485501), ('save daily', 98.03586853418446), ('delight paytm', 3.920523474443698), ('country delight', 3.9147386407433222)])]"
452,17/12/22,IB SS FUNDS TRANSFER DR-55000002937593,000000000000000,17/12/22,80000.0,,34367.37,ib ss funds transfer,2,"[list([('gupta juice', 19.243605119465393), ('gupta juice center', 19.24314059509313), ('juice center', 19.241968449100682), ('krishna vegetables', 4.4101114348673125), ('cred club', 3.506991506858471)])]"
453,17/12/22,UPI-AAYUSHI SUPER SHOPPY-Q392022159@YBL-YESB0YBLUPI-235184062508-UPI,0000235184062508,17/12/22,318.0,,34049.37, aayushi super shoppy,0,"[list([('aayushi super', 10.865290481053918), ('super shoppy', 10.865173862517079), ('aayushi super shoppy', 10.864427223847468), ('pos xxxxxx', 2.4550385779352015), ('ikea india', 1.609971068597172)])]"
454,18/12/22,UPI-JAR  SAVE DAILY-JARMYJARONLINE@YBL-YESB0YBLUPI-235294345335-SUBSCRIPTION DEBIT,0000235294345335,18/12/22,39.0,,34010.37, jar save daily,1,"[list([('jar save daily', 98.03861898739333), ('jar save', 98.03682857485501), ('save daily', 98.03586853418446), ('delight paytm', 3.920523474443698), ('country delight', 3.9147386407433222)])]"
455,19/12/22,UPI-JAR  SAVE DAILY-JARMYJARONLINE@YBL-YESB0YBLUPI-235362561591-SUBSCRIPTION DEBIT,0000235362561591,19/12/22,37.0,,33973.37, jar save daily,1,"[list([('jar save daily', 98.03861898739333), ('jar save', 98.03682857485501), ('save daily', 98.03586853418446), ('delight paytm', 3.920523474443698), ('country delight', 3.9147386407433222)])]"
456,19/12/22,UPI-AAYUSHI SUPER SHOPPY-Q392022159@YBL-YESB0YBLUPI-235333260952-UPI,0000235333260952,19/12/22,602.0,,33371.37, aayushi super shoppy,0,"[list([('aayushi super', 10.865290481053918), ('super shoppy', 10.865173862517079), ('aayushi super shoppy', 10.864427223847468), ('pos xxxxxx', 2.4550385779352015), ('ikea india', 1.609971068597172)])]"
457,19/12/22,UPI-LAKSHMI STORES-PAYTMQR281005050101O4J4AEEIS49G@PAYTM-PYTM0123456-235333471222-UPI,0000235333471222,19/12/22,100.0,,33271.37, lakshmi stores paytmqr,7,"[list([('raj vegetables gpay', 4.360523938382696), ('vegetables gpay', 4.3601697153875785), ('raj vegetables', 4.359825827176104), ('stores paytmqr', 3.567746696089187), ('hair glow', 2.506362310298007)])]"
458,19/12/22,UPI-GUPTA JUICE CENTER-PAYTMQR281005050101HU81CCP8WBFM@PAYTM-PYTM0123456-235333551871-UPI,0000235333551871,19/12/22,50.0,,33221.37, gupta juice center,2,"[list([('gupta juice', 19.243605119465393), ('gupta juice center', 19.24314059509313), ('juice center', 19.241968449100682), ('krishna vegetables', 4.4101114348673125), ('cred club', 3.506991506858471)])]"
459,20/12/22,UPI-COUNTRY DELIGHT-PAYTM-31857153@PAYTM-PYTM0123456-235406126731-OIDCDJPMAN73795438,0000235406126731,20/12/22,1500.0,,31721.37, country delight paytm,1,"[list([('jar save daily', 98.03861898739333), ('jar save', 98.03682857485501), ('save daily', 98.03586853418446), ('delight paytm', 3.920523474443698), ('country delight', 3.9147386407433222)])]"
460,20/12/22,UPI-JAR  SAVE DAILY-JARMYJARONLINE@YBL-YESB0YBLUPI-235439386960-SUBSCRIPTION DEBIT,0000235439386960,20/12/22,32.0,,31689.37, jar save daily,1,"[list([('jar save daily', 98.03861898739333), ('jar save', 98.03682857485501), ('save daily', 98.03586853418446), ('delight paytm', 3.920523474443698), ('country delight', 3.9147386407433222)])]"
461,20/12/22,UPI-PATEL PREMJI-PAYTMQR28100505010116F2O17R71H4@PAYTM-PYTM0123456-235460465061-UPI,0000235460465061,20/12/22,120.0,,31569.37, patel premji paytmqr,3,"[list([('hungerbox paytm', 13.174251604078895), ('aeml awsp', 3.595276358492651), ('ccavenues ccavenues', 2.5585233143451727), ('premji paytmqr', 1.5287022749836985), ('patel premji paytmqr', 1.5276871161621721)])]"
462,21/12/22,UPI-JAR  SAVE DAILY-JARMYJARONLINE@YBL-YESB0YBLUPI-235593682647-SUBSCRIPTION DEBIT,0000235593682647,21/12/22,40.0,,31529.37, jar save daily,1,"[list([('jar save daily', 98.03861898739333), ('jar save', 98.03682857485501), ('save daily', 98.03586853418446), ('delight paytm', 3.920523474443698), ('country delight', 3.9147386407433222)])]"
463,22/12/22,UPI-JAR  SAVE DAILY-JARMYJARONLINE@YBL-YESB0YBLUPI-235633482158-SUBSCRIPTION DEBIT,0000235633482158,22/12/22,34.0,,31495.37, jar save daily,1,"[list([('jar save daily', 98.03861898739333), ('jar save', 98.03682857485501), ('save daily', 98.03586853418446), ('delight paytm', 3.920523474443698), ('country delight', 3.9147386407433222)])]"
464,22/12/22,UPI-GUPTA JUICE CENTER-PAYTMQR281005050101HU81CCP8WBFM@PAYTM-PYTM0123456-235601504595-UPI,0000235601504595,22/12/22,50.0,,31445.37, gupta juice center,2,"[list([('gupta juice', 19.243605119465393), ('gupta juice center', 19.24314059509313), ('juice center', 19.241968449100682), ('krishna vegetables', 4.4101114348673125), ('cred club', 3.506991506858471)])]"
465,22/12/22,UPI-VIRKAR VINAY VASANT-Q981616939@YBL-YESB0YBLUPI-235601611365-UPI,0000235601611365,22/12/22,100.0,,31345.37, virkar vinay vasant,0,"[list([('aayushi super', 10.865290481053918), ('super shoppy', 10.865173862517079), ('aayushi super shoppy', 10.864427223847468), ('pos xxxxxx', 2.4550385779352015), ('ikea india', 1.609971068597172)])]"
467,23/12/22,UPI-JAR  SAVE DAILY-JARMYJARONLINE@YBL-YESB0YBLUPI-235783620209-SUBSCRIPTION DEBIT,0000235783620209,23/12/22,20.0,,40325.37, jar save daily,1,"[list([('jar save daily', 98.03861898739333), ('jar save', 98.03682857485501), ('save daily', 98.03586853418446), ('delight paytm', 3.920523474443698), ('country delight', 3.9147386407433222)])]"
468,23/12/22,UPI-HUNGERBOX-PAYTM-8774066@PAYTM-PYTM0123456-235705710031-UPI,0000235705710031,23/12/22,52.0,,40273.37, hungerbox paytm ,3,"[list([('hungerbox paytm', 13.174251604078895), ('aeml awsp', 3.595276358492651), ('ccavenues ccavenues', 2.5585233143451727), ('premji paytmqr', 1.5287022749836985), ('patel premji paytmqr', 1.5276871161621721)])]"
469,23/12/22,UPI-GUPTA JUICE CENTER-PAYTMQR281005050101HU81CCP8WBFM@PAYTM-PYTM0123456-235722461595-UPI,0000235722461595,23/12/22,50.0,,40223.37, gupta juice center,2,"[list([('gupta juice', 19.243605119465393), ('gupta juice center', 19.24314059509313), ('juice center', 19.241968449100682), ('krishna vegetables', 4.4101114348673125), ('cred club', 3.506991506858471)])]"
470,24/12/22,UPI-JAR  SAVE DAILY-JARMYJARONLINE@YBL-YESB0YBLUPI-235842051115-SUBSCRIPTION DEBIT,0000235842051115,24/12/22,40.0,,40183.37, jar save daily,1,"[list([('jar save daily', 98.03861898739333), ('jar save', 98.03682857485501), ('save daily', 98.03586853418446), ('delight paytm', 3.920523474443698), ('country delight', 3.9147386407433222)])]"
471,24/12/22,UPI-GUPTA JUICE CENTER-PAYTMQR281005050101HU81CCP8WBFM@PAYTM-PYTM0123456-235848357961-UPI,0000235848357961,24/12/22,50.0,,40133.37, gupta juice center,2,"[list([('gupta juice', 19.243605119465393), ('gupta juice center', 19.24314059509313), ('juice center', 19.241968449100682), ('krishna vegetables', 4.4101114348673125), ('cred club', 3.506991506858471)])]"
472,24/12/22,UPI-AAYUSHI SUPER SHOPPY-Q392022159@YBL-YESB0YBLUPI-235848966361-UPI,0000235848966361,24/12/22,385.0,,39748.37, aayushi super shoppy,0,"[list([('aayushi super', 10.865290481053918), ('super shoppy', 10.865173862517079), ('aayushi super shoppy', 10.864427223847468), ('pos xxxxxx', 2.4550385779352015), ('ikea india', 1.609971068597172)])]"
473,24/12/22,UPI-AAYUSHI SUPER SHOPPY-Q392022159@YBL-YESB0YBLUPI-235849020711-UPI,0000235849020711,24/12/22,117.0,,39631.37, aayushi super shoppy,0,"[list([('aayushi super', 10.865290481053918), ('super shoppy', 10.865173862517079), ('aayushi super shoppy', 10.864427223847468), ('pos xxxxxx', 2.4550385779352015), ('ikea india', 1.609971068597172)])]"
474,24/12/22,UPI-RAJ VEGETABLES-GPAY-11204598532@OKBIZAXIS-UTIB0000000-235849059379-UPI,0000235849059379,24/12/22,30.0,,39601.37, raj vegetables gpay,7,"[list([('raj vegetables gpay', 4.360523938382696), ('vegetables gpay', 4.3601697153875785), ('raj vegetables', 4.359825827176104), ('stores paytmqr', 3.567746696089187), ('hair glow', 2.506362310298007)])]"
475,25/12/22,UPI-JAR  SAVE DAILY-JARMYJARONLINE@YBL-YESB0YBLUPI-235934175357-SUBSCRIPTION DEBIT,0000235934175357,25/12/22,38.0,,39563.37, jar save daily,1,"[list([('jar save daily', 98.03861898739333), ('jar save', 98.03682857485501), ('save daily', 98.03586853418446), ('delight paytm', 3.920523474443698), ('country delight', 3.9147386407433222)])]"
476,25/12/22,UPI-RAJE GOWDA H E-Q377924986@YBL-YESB0YBLUPI-235962980501-UPI,0000235962980501,25/12/22,200.0,,39363.37, raje gowda h,0,"[list([('aayushi super', 10.865290481053918), ('super shoppy', 10.865173862517079), ('aayushi super shoppy', 10.864427223847468), ('pos xxxxxx', 2.4550385779352015), ('ikea india', 1.609971068597172)])]"
477,26/12/22,UPI-JAR  SAVE DAILY-JARMYJARONLINE@YBL-YESB0YBLUPI-236019380884-SUBSCRIPTION DEBIT,0000236019380884,26/12/22,35.0,,39328.37, jar save daily,1,"[list([('jar save daily', 98.03861898739333), ('jar save', 98.03682857485501), ('save daily', 98.03586853418446), ('delight paytm', 3.920523474443698), ('country delight', 3.9147386407433222)])]"
478,26/12/22,UPI-HUNGERBOX-PAYTM-8774066@PAYTM-PYTM0123456-236075596565-UPI,0000236075596565,26/12/22,52.0,,39276.37, hungerbox paytm ,3,"[list([('hungerbox paytm', 13.174251604078895), ('aeml awsp', 3.595276358492651), ('ccavenues ccavenues', 2.5585233143451727), ('premji paytmqr', 1.5287022749836985), ('patel premji paytmqr', 1.5276871161621721)])]"
479,26/12/22,UPI-HUNGERBOX-PAYTM-8774066@PAYTM-PYTM0123456-236081243399-UPI,0000236081243399,26/12/22,54.0,,39222.37, hungerbox paytm ,3,"[list([('hungerbox paytm', 13.174251604078895), ('aeml awsp', 3.595276358492651), ('ccavenues ccavenues', 2.5585233143451727), ('premji paytmqr', 1.5287022749836985), ('patel premji paytmqr', 1.5276871161621721)])]"
480,26/12/22,UPI-AAYUSHI SUPER SHOPPY-Q392022159@YBL-YESB0YBLUPI-236091878726-UPI,0000236091878726,26/12/22,530.0,,38692.37, aayushi super shoppy,0,"[list([('aayushi super', 10.865290481053918), ('super shoppy', 10.865173862517079), ('aayushi super shoppy', 10.864427223847468), ('pos xxxxxx', 2.4550385779352015), ('ikea india', 1.609971068597172)])]"
481,26/12/22,UPI-RAJ VEGETABLES-GPAY-11204598532@OKBIZAXIS-UTIB0000000-236091925426-UPI,0000236091925426,26/12/22,440.0,,38252.37, raj vegetables gpay,7,"[list([('raj vegetables gpay', 4.360523938382696), ('vegetables gpay', 4.3601697153875785), ('raj vegetables', 4.359825827176104), ('stores paytmqr', 3.567746696089187), ('hair glow', 2.506362310298007)])]"
482,26/12/22,UPI-GUPTA JUICE CENTER-PAYTMQR281005050101HU81CCP8WBFM@PAYTM-PYTM0123456-236092094559-UPI,0000236092094559,26/12/22,50.0,,38202.37, gupta juice center,2,"[list([('gupta juice', 19.243605119465393), ('gupta juice center', 19.24314059509313), ('juice center', 19.241968449100682), ('krishna vegetables', 4.4101114348673125), ('cred club', 3.506991506858471)])]"
483,26/12/22,UPI-TIRUPATI CHEMIST-PAYTMQR281005050101IA5OF9Q315X5@PAYTM-PYTM0123456-236094003114-UPI,0000236094003114,26/12/22,75.0,,38127.37, tirupati chemist paytmqr,6,"[list([('chemist paytmqr', 3.9972774836044023), ('tirupati chemist', 3.9967234821483877), ('tirupati chemist paytmqr', 3.9965107262676147), ('akash bhatt', 2.709151344546336), ('makemytrip makemytrip', 2.077909670466702)])]"
485,27/12/22,UPI-JAR  SAVE DAILY-JARMYJARONLINE@YBL-YESB0YBLUPI-236183627346-SUBSCRIPTION DEBIT,0000236183627346,27/12/22,34.0,,38094.37, jar save daily,1,"[list([('jar save daily', 98.03861898739333), ('jar save', 98.03682857485501), ('save daily', 98.03586853418446), ('delight paytm', 3.920523474443698), ('country delight', 3.9147386407433222)])]"
486,27/12/22,UPI-HUNGERBOX-PAYTM-8774066@PAYTM-PYTM0123456-236197538179-UPI,0000236197538179,27/12/22,36.0,,38058.37, hungerbox paytm ,3,"[list([('hungerbox paytm', 13.174251604078895), ('aeml awsp', 3.595276358492651), ('ccavenues ccavenues', 2.5585233143451727), ('premji paytmqr', 1.5287022749836985), ('patel premji paytmqr', 1.5276871161621721)])]"
487,27/12/22,UPI-HUNGERBOX-PAYTM-8774066@PAYTM-PYTM0123456-236197668784-UPI,0000236197668784,27/12/22,10.0,,38048.37, hungerbox paytm ,3,"[list([('hungerbox paytm', 13.174251604078895), ('aeml awsp', 3.595276358492651), ('ccavenues ccavenues', 2.5585233143451727), ('premji paytmqr', 1.5287022749836985), ('patel premji paytmqr', 1.5276871161621721)])]"
488,27/12/22,UPI-RAJESH-LUCKNOWLEDGE@OKAXIS-KKBK0001244-236107381082-UPI,0000236107381082,27/12/22,50.0,,37998.37, rajesh lucknowledge,0,"[list([('aayushi super', 10.865290481053918), ('super shoppy', 10.865173862517079), ('aayushi super shoppy', 10.864427223847468), ('pos xxxxxx', 2.4550385779352015), ('ikea india', 1.609971068597172)])]"
489,27/12/22,UPI-AVDHESH YADAV-PAYTMQR28100505010177MU6PLOMWNV@PAYTM-PYTM0123456-236107413870-UPI,0000236107413870,27/12/22,20.0,,37978.37, avdhesh yadav paytmqr,0,"[list([('aayushi super', 10.865290481053918), ('super shoppy', 10.865173862517079), ('aayushi super shoppy', 10.864427223847468), ('pos xxxxxx', 2.4550385779352015), ('ikea india', 1.609971068597172)])]"
490,28/12/22,UPI-JAR  SAVE DAILY-JARMYJARONLINE@YBL-YESB0YBLUPI-236260014428-SUBSCRIPTION DEBIT,0000236260014428,28/12/22,40.0,,37938.37, jar save daily,1,"[list([('jar save daily', 98.03861898739333), ('jar save', 98.03682857485501), ('save daily', 98.03586853418446), ('delight paytm', 3.920523474443698), ('country delight', 3.9147386407433222)])]"
491,28/12/22,UPI-HUNGERBOX-PAYTM-8774066@PAYTM-PYTM0123456-236225009153-UPI,0000236225009153,28/12/22,15.0,,37923.37, hungerbox paytm ,3,"[list([('hungerbox paytm', 13.174251604078895), ('aeml awsp', 3.595276358492651), ('ccavenues ccavenues', 2.5585233143451727), ('premji paytmqr', 1.5287022749836985), ('patel premji paytmqr', 1.5276871161621721)])]"
492,29/12/22,UPI-JAR  SAVE DAILY-JARMYJARONLINE@YBL-YESB0YBLUPI-236319987027-SUBSCRIPTION DEBIT,0000236319987027,29/12/22,38.0,,37885.37, jar save daily,1,"[list([('jar save daily', 98.03861898739333), ('jar save', 98.03682857485501), ('save daily', 98.03586853418446), ('delight paytm', 3.920523474443698), ('country delight', 3.9147386407433222)])]"
494,29/12/22,UPI-HUNGERBOX-PAYTM-8774066@PAYTM-PYTM0123456-236351876268-UPI,0000236351876268,29/12/22,48.0,,169784.37, hungerbox paytm ,3,"[list([('hungerbox paytm', 13.174251604078895), ('aeml awsp', 3.595276358492651), ('ccavenues ccavenues', 2.5585233143451727), ('premji paytmqr', 1.5287022749836985), ('patel premji paytmqr', 1.5276871161621721)])]"
495,29/12/22,UPI-HUNGERBOX-PAYTM-8774066@PAYTM-PYTM0123456-236351940257-UPI,0000236351940257,29/12/22,30.0,,169754.37, hungerbox paytm ,3,"[list([('hungerbox paytm', 13.174251604078895), ('aeml awsp', 3.595276358492651), ('ccavenues ccavenues', 2.5585233143451727), ('premji paytmqr', 1.5287022749836985), ('patel premji paytmqr', 1.5276871161621721)])]"
496,29/12/22,UPI-SUMIT MOHAN GUPTA-SUMITMG@OKICICI-BARB0PANKIX-236357465278-EDUCATION LOAN,0000236357465278,29/12/22,24000.0,,145754.37, sumit mohan gupta,8,"[list([('sumit mohan', 4.505268486902978), ('mohan gupta', 4.504494554311667), ('sumit mohan gupta', 4.502622451115006), ('jiofiber jiofiber', 2.613046376779851), ('olamoney razorpay', 1.7976716994787716)])]"
497,29/12/22,UPI-NATIONAL HIGHWAY TRU-PAYTMQR28100505010110PUJ60DNSEE@PAYTM-PYTM0123456-236359403520-UPI,0000236359403520,29/12/22,400.0,,145354.37, national highway tru,0,"[list([('aayushi super', 10.865290481053918), ('super shoppy', 10.865173862517079), ('aayushi super shoppy', 10.864427223847468), ('pos xxxxxx', 2.4550385779352015), ('ikea india', 1.609971068597172)])]"
498,29/12/22,UPI-GUPTA JUICE CENTER-PAYTMQR281005050101HU81CCP8WBFM@PAYTM-PYTM0123456-236359601227-UPI,0000236359601227,29/12/22,50.0,,145304.37, gupta juice center,2,"[list([('gupta juice', 19.243605119465393), ('gupta juice center', 19.24314059509313), ('juice center', 19.241968449100682), ('krishna vegetables', 4.4101114348673125), ('cred club', 3.506991506858471)])]"
499,29/12/22,UPI-AAYUSHI SUPER SHOPPY-Q392022159@YBL-YESB0YBLUPI-236359787681-UPI,0000236359787681,29/12/22,660.0,,144644.37, aayushi super shoppy,0,"[list([('aayushi super', 10.865290481053918), ('super shoppy', 10.865173862517079), ('aayushi super shoppy', 10.864427223847468), ('pos xxxxxx', 2.4550385779352015), ('ikea india', 1.609971068597172)])]"
500,29/12/22,UPI-LAKSHMI STORES-PAYTMQR281005050101O4J4AEEIS49G@PAYTM-PYTM0123456-236359865059-UPI,0000236359865059,29/12/22,210.0,,144434.37, lakshmi stores paytmqr,7,"[list([('raj vegetables gpay', 4.360523938382696), ('vegetables gpay', 4.3601697153875785), ('raj vegetables', 4.359825827176104), ('stores paytmqr', 3.567746696089187), ('hair glow', 2.506362310298007)])]"
501,29/12/22,UPI-ELECTRONICSCOMP COM-ELECTRONICSCOMP1.RZP@ICICI-ICIC0DC0099-236319647266-ELECTRONICSCOMPCOM,0000236319647266,29/12/22,10565.84,,133868.53, electronicscomp com electronicscomp,0,"[list([('aayushi super', 10.865290481053918), ('super shoppy', 10.865173862517079), ('aayushi super shoppy', 10.864427223847468), ('pos xxxxxx', 2.4550385779352015), ('ikea india', 1.609971068597172)])]"
502,29/12/22,UPI-KOPAL CHOUHAN-CHAUHAN.KOPAL@OKHDFCBANK-HDFC0000036-236362944531-UPI,0000236362944531,29/12/22,37000.0,,96868.53, kopal chouhan chauhan,2,"[list([('gupta juice', 19.243605119465393), ('gupta juice center', 19.24314059509313), ('juice center', 19.241968449100682), ('krishna vegetables', 4.4101114348673125), ('cred club', 3.506991506858471)])]"
503,30/12/22,UPI-JAR  SAVE DAILY-JARMYJARONLINE@YBL-YESB0YBLUPI-236446125381-SUBSCRIPTION DEBIT,0000236446125381,30/12/22,36.0,,96832.53, jar save daily,1,"[list([('jar save daily', 98.03861898739333), ('jar save', 98.03682857485501), ('save daily', 98.03586853418446), ('delight paytm', 3.920523474443698), ('country delight', 3.9147386407433222)])]"
504,31/12/22,UPI-JAR  SAVE DAILY-JARMYJARONLINE@YBL-YESB0YBLUPI-236564094995-SUBSCRIPTION DEBIT,0000236564094995,31/12/22,40.0,,96792.53, jar save daily,1,"[list([('jar save daily', 98.03861898739333), ('jar save', 98.03682857485501), ('save daily', 98.03586853418446), ('delight paytm', 3.920523474443698), ('country delight', 3.9147386407433222)])]"
505,31/12/22,UPI-HAIR GLOW-9819103125@OKBIZAXIS-UTIB0000000-236595133822-UPI,0000236595133822,31/12/22,800.0,,95992.53, hair glow ,7,"[list([('raj vegetables gpay', 4.360523938382696), ('vegetables gpay', 4.3601697153875785), ('raj vegetables', 4.359825827176104), ('stores paytmqr', 3.567746696089187), ('hair glow', 2.506362310298007)])]"
507,31/12/22,UPI-MAHAVIR THE HOME STO-Q80990057@YBL-YESB0YBLUPI-236507176614-UPI,0000236507176614,31/12/22,2998.0,,94397.92, mahavir the home,0,"[list([('aayushi super', 10.865290481053918), ('super shoppy', 10.865173862517079), ('aayushi super shoppy', 10.864427223847468), ('pos xxxxxx', 2.4550385779352015), ('ikea india', 1.609971068597172)])]"
508,31/12/22,UPI-AAYUSHI SUPER SHOPPY-Q392022159@YBL-YESB0YBLUPI-236509057794-UPI,0000236509057794,31/12/22,158.0,,94239.92, aayushi super shoppy,0,"[list([('aayushi super', 10.865290481053918), ('super shoppy', 10.865173862517079), ('aayushi super shoppy', 10.864427223847468), ('pos xxxxxx', 2.4550385779352015), ('ikea india', 1.609971068597172)])]"
